一	h
丁	hs
七	hz
万	hzp
丈	hpn
三	hhh
上	shh
下	hsn
不	hpsn
与	hzh
丐	hshz
丑	zshh
专	hhzn
且	szhhh
丕	hpsnh
世	hsshz
亻	ps
丘	pshsh
丙	hszpn
业	ssnph
丛	pnpnh
东	hzspn
丝	zzzzh
丞	zszpnh
丟	hhshzn
丢	phshzn
两	hszpnpn
严	hssnphp
丧	hsnphzpn
丨	s
中	szhs
丰	hhhs
串	szhszhs
临	ssphnszsh
丸	pzn
丹	pznh
言	nhhhszh
为	npzn
主	nhhsh
丽	hsznszn
举	nnphpnhhs
乃	zp
久	pzn
么	pzn
义	npn
之	nzn
乌	pzzh
乍	phshh
乎	pnphs
乏	pnzn
乐	pzspn
乒	pshshp
乓	pshshn
乔	phpnps
乖	phsshhpz
乘	phsshhpzpn
乙	z
九	pz
乞	phz
也	zsz
习	znh
乡	zzp
书	zzsn
乩	shszhz
买	znnhpn
乱	phsszhz
乲	nhpzpnz
乳	pnnpzshz
了	zs
予	znzs
争	pzzhhs
事	hszhzhhs
二	hh
于	hhs
亏	hhz
云	hhzn
互	hzzh
五	hszh
井	hhps
亘	hszhhh
亚	hssnph
些	shshpzhh
亟	zsszhznh
亡	nhz
亢	nhpz
交	nhpnpn
亥	nhzppn
亦	nhpspn
产	nhnphp
亨	nhszhzs
亩	nhszhsh
享	nhszhzsh
京	nhszhspn
亭	nhszhnzhs
亮	nhszhnzpz
亲	nhnphhspn
亵	nhhshpznpzpn
人	pn
亿	psz
什	pshs
仁	pshh
仃	pshs
仄	hppn
仅	pszn
仆	pssn
仇	pspz
仉	pspz
今	pnnz
介	pnps
仍	pszp
从	pnpn
仏	pszn
仑	pnpz
仓	pnzz
仔	pszsh
仕	pshsh
他	pszsz
仗	pshpn
付	pshsn
仙	psszs
仞	pszpn
仟	psphs
仠	pshhs
仡	psphz
仢	pspzn
代	pshzn
令	pnnzn
以	znpn
仨	pshhh
仩	psshh
仪	psnpn
们	psnsz
仭	pszpn
仰	pspzzs
仱	pspnnz
仲	psszhs
仵	psphhs
件	psphhs
价	pspnps
任	psphsh
份	pspnzp
仿	psnhzp
企	pnshsh
伃	psznzs
伇	pspzzn
伉	psnhpz
伊	pszhhp
伌	pshpzz
伍	pshszh
伎	pshszn
伏	pshpnn
伐	pshzpn
休	pshspn
伕	pshhpn
众	pnpnpn
优	pshpzn
伙	psnppn
会	pnhhzn
伛	pshpnz
伝	pshhzn
伞	pnnphs
伟	pshhzs
传	pshhzn
伢	pshzsp
伤	psphzp
伥	psphzn
伦	pspnpz
伧	pspnzz
伪	psnpzn
伫	psnnzh
伬	pszhpn
伯	pspszhh
估	pshsszh
伴	psnphhs
伸	psszhhs
伺	pszhszh
似	psznpn
伽	pszpszh
佃	psszhsh
但	psszhhh
位	psnhnph
低	pspzhzn
住	psnhhsh
佐	pshphsh
佑	pshpszh
佒	psszhpn
体	pshspnh
佔	psshszh
何	pshszhs
佖	psnznpn
佗	psnnzpz
佘	pnhhspn
余	pnhhspn
佚	psphhpn
佛	pszhzps
作	psphshh
佝	pspzszh
佞	pshhzph
佟	pspznnn
你	pspzspn
佢	pshzhz
佣	pspzhhs
佤	pshzzn
佥	pnhnnph
佦	pshpszh
佧	psshhsn
佨	pspzzhz
佩	pspzhszs
佪	psszszhh
佫	pspznszh
佬	pshshppz
佭	pspznhzs
佮	pspnhszh
佯	psnphhhs
佰	pshpszhh
佲	pspznszh
佳	pshshhsh
佴	pshsshhh
併	psnphhps
佶	pshshszh
佷	pszhhzpn
佸	psphsszh
佹	pspzhpzz
佺	pspnhhsh
佻	pspnhzpn
佼	psnhpnpn
使	pshszhpn
侀	pshhpsss
侁	psphshpz
侃	psszhpsz
侄	pshznhsh
來	hpnpnspn
侇	pshzhzpn
侈	pspznpzn
侉	pshpnhhz
侊	pssnphpz
例	pshpznss
侍	pshshhsn
侎	psnphspn
侏	psphhspn
侐	pspszssh
侒	psnnzzph
侓	pszhhhhs
侖	pnhszhss
侗	psszhszh
侘	psnnzphz
侙	pshhshzn
侚	pspzszhh
供	pshsshpn
依	psnhpzpn
侞	pszphszh
侠	pshnphpn
侣	psszhszh
侤	pshshphz
侥	pshzphpz
侦	psshszpn
侧	psszpnss
侨	psphpnps
侩	pspnhhzn
侪	psnhpnps
侫	psnhzzph
侬	psnzpzpn
侭	pszhpnnn
侮	psphzznhn
侯	pszhphhpn
侰	pszhhpszh
侱	psszhhhsh
侲	pshphhzpn
侳	pspnpnhsh
侵	pszhhnzzn
侶	psszhpszh
侷	pszhpzszh
侸	pshszhnph
侹	psphshzn
侺	psszspnnz
侻	psnpszhpz
侼	pshsnzzsh
便	pshszhhpn
俀	pspnnpzph
促	psszhshpn
俄	psphshzpn
俅	pshsnhpnn
俆	pspnhhspn
俇	pspzphhsh
俈	psphshszh
俉	pshszhszh
俊	psznpnpzn
俋	psszhzshz
俌	pshszhhsn
俍	psnzhhzpn
俎	pnpnszhhh
俏	pssnpszhh
俐	psphspnss
俑	psznszhhs
俒	psnnzhhpz
俗	pspnpnszh
俘	pspnnpzsh
俙	pspnhpszh
俚	psszhhshh
俛	pspzszhpz
保	psszhhspn
俞	pnhszhhss
俟	psznphhpn
俠	pshpnpnpn
信	psnhhhszh
俢	pspznppp
俣	psszhhhpn
俤	psnpzhzsp
俥	pshszhhhs
俦	pshhhphsn
俧	pshshnznn
俨	pshssnphp
俩	pshszpnpn
俪	pshsznszn
俫	pshnphspn
俬	psphspnzn
俭	pspnhnnph
修	psspznppp
俯	psnhppshsn
俱	psszhhhhpn
俳	psshhhshhh
俵	pshhshpzpn
俶	psshhspnzn
俷	pspzhhzshz
俸	pshhhpnhhs
俺	pshpnszhhz
俽	pspphspzpn
俾	pspszhhphs
俿	psshzphzpz
倀	pshshhhzpn
倃	pspznsnszh
倄	pspnhpszhh
倅	psnhpnpnhs
倆	pshszspnpn
倇	psnnzpznzz
倈	pshpnpnspn
個	psszhsszhh
倌	psnnzszhzh
倍	psnhnphszh
倎	psszhsshpn
倏	psspznhpnn
倐	psspznnppn
們	psszhhszhh
倒	pshznhshss
倓	psnppnnppn
倔	pszhpzsszs
倕	psphshsshh
倖	pshshnphhs
倗	pspzhhpzhh
倘	pssnpszszh
候	psszhphhpn
倚	pshpnhszhs
倛	pshsshhhpn
倜	pspzhshszh
倞	psnhszhspn
借	pshsshszhh
倠	pspsnhhhsh
倡	psszhhszhh
倢	pshzhhshpn
倥	psnnzpnhsh
倦	psnphhpnzz
倧	psnnzhhspn
倨	pszhphsszh
倩	pshhshszhh
倫	pspnhszhss
倬	psshszhhhs
倭	psphspnzph
倮	psszhhhspn
倯	pshspnpnzn
倰	pshshpnpzn
倳	pshszhzhhs
倴	pshpnhshps
倶	psszhhhhpn
倷	pshpnhhspn
债	pshhshszpn
倻	pshsshhhzs
值	pshsszhhhh
倽	pspnhhsszh
倾	pshzhpszpn
偃	pshszhhzphz
偆	pshhhpnszhh
假	pszhshhzhzn
偈	psszhhpzpnz
偋	pszhpnphhps
偌	pshsshpszh
偍	psszhhhshpn
偎	psszhshhzpn
偏	psnzhpszhss
偐	psnhnphpppp
偒	psszhhhpzpp
偓	pszhphznhsh
偔	psszhszhhhz
偕	pshzpzpszhh
偖	pshshpszhh
偘	psszhszhszh
偙	psnhnpnzszs
做	pshsszhphpn
偛	psphspshzhh
停	psnhszhnzhs
偞	pshsshzhspn
偟	pspszhhhhsh
偠	pshszsshzph
偡	pshsshhhpnz
偢	psphspnnppn
偣	psnhnphszhh
偤	psnphszpzhh
健	pszhhhhszn
偦	pszshpnszhh
偧	pshpnpznpzn
偩	pspzszhhhpn
偪	pshszhszhsh
偬	pspzppnnznn
偭	pshpszsshhh
偮	psszhhsshhh
偯	psnhszhpzpn
偰	pshhhszphpn
偱	pspphsszhhh
偲	psszhshnznn
偳	psszshpszss
側	psszhhhpnss
偵	psshszhhhpn
偶	psszhhszshn
偷	pspnhszhhss
偹	psspznszhsh
偻	psnphspnzph
偾	pshshssszpn
偿	pssnpnzhhzn
傀	pspszhhpzzn
傁	pspshzhhszn
傂	psppshzphzpz
傃	pshhshzznspn
傅	pshszhhsnhsn
傉	pshphhzpnhsn
傊	psszhszhhhpn
傋	pshhsshszshh
傍	psnhnpnznhzp
傎	pshsszhhhhpn
傏	psnhpzhhsszh
傐	psnhszhszszh
傑	pspznhzshspn
傓	psnzhpznhznh
傔	psnphzhhsspn
傕	psnzpsnhhhsh
傗	psnhzznszhsh
備	pshsshpszhhs
傛	psnnzpnpnszh
傜	pspnnpphhszs
傝	psszhhznhznh
傞	psnphhhphsh
傢	psnnzhpzpppn
傣	pshhhpnsnhpn
傥	pssnpnzszhpz
傦	psszznzszhh
傧	psnnzpshshpn
储	psnzhshpszhh
傩	psznpsnhhhsh
傪	psznznznpnppp
傫	psszhshzznspn
催	psszspsnhhhsh
傭	psnhpzhhszhhs
傮	pshszhsshszhh
傯	pspszpznhnznn
傰	psszspzhhpzhh
傲	pshhshzpphpn
傳	pshszhhshnhsn
傴	pshszhszhszhz
債	pshhshszhhhpn
傶	pshpshhspnzpn
傷	psphszhhhpzpp
傸	pshpnpnpnpnpn
傹	psnhnphszhhpz
傺	pspznnznhhspn
傻	pspszpnhpnpzn
傽	psnhnphszhhhs
傾	pshzhpszhhhpn
僅	pshsshszhhhsh
僆	pshszhhhsnzn
僇	psznhznhpnppp
僈	psszhhszsshzn
像	pspzszhpzpppn
僐	psnphhhsnphszh
僒	psnnzpnzhhpszh
僓	psszhshszhhhpn
僔	psnphszpzhhhsn
僕	psssnphnphhhpn
僖	pshshszhnphszh
僙	pshsshszhshpn
僚	pshpnnpszhhspn
僛	pshsshhhpnpzpn
僜	psznppnhszhnph
僝	pszhpzshzshzsh
僠	pspnphspnszhsh
僣	pshhpnhhpnszhh
僧	psnpszsnphszhh
僬	pspsnhhhshnnnn
僮	psnhnphszhhshh
僯	psnphspnpznhzs
僱	psnzhppsnhhhsh
僵	pshszhshhszhshh
僻	pszhpszhnhnphhs
儫	psnhszhnzhpzpppn
儬	pshhshszhhszhhhpz
儿	pz
兀	hpz
允	znpz
兂	hzpz
元	hhpz
兄	szhpz
充	nhznpz
兆	pnhzpn
兇	pnzspz
先	phshpz
光	snphpz
兊	pnznpz
克	hsszhpz
免	pzszhpz
兑	npszhpz
兔	pzszhpzn
兕	szszhpz
兖	nhpnznpz
兗	nhpnszhpz
兙	hsszhpzhs
党	snpnzszhpz
兛	hsszhpzphs
兜	pszhhpzzhpz
入	pn
內	szpn
全	pnhhsh
兩	hszspnpn
八	pn
公	pnzn
六	nhpn
兮	pnhz
兰	nphhh
共	hsshpn
关	nphhpn
兴	nnphpn
兵	pshshpn
其	hsshhhpn
具	szhhhhpn
典	szhsshpn
兹	nphzznzzn
养	nphhhpnps
兼	nphzhhsspn
兽	npszhshhszh
内	szpn
円	szsh
冈	szpn
冉	szshh
册	pzpzh
再	hszshh
冐	szhhszhh
冑	szhshszhh
冒	szhhszhhh
冓	hhsshszshh
冕	szhhpzszhpz
冗	nzpz
冘	nzpz
写	nzhzh
冚	nzszs
军	nzhzhs
农	nzpzpn
冝	nzszhhh
冠	nzhhpzhsn
冡	nzhhpzpppn
冢	nzhpzppnpn
冣	nzhsshhhzn
冤	nzpzszhpzn
冥	nzszhhnhpn
冦	nzhhpzshzn
冧	nzhspnhspn
冨	nzhszhszhsh
冪	nzhssszhhhpnszs
冬	pznnn
冮	nhhsh
冯	nhzzh
冰	nhszpn
冱	nhhzzh
冲	nhszhs
决	nhzhpn
冴	nhhzsp
况	nhszhpz
冶	nhznszh
冷	nhpnnzn
冸	nhnphhs
冹	nhhpznn
冺	nhzhzhz
冻	nhhzspn
冼	nhphshpz
冽	nhhpznss
冾	nhpnhszh
冿	nhzhhhhs
净	nhpzzhhs
凁	nhhszhspn
凂	nhpzszhpz
凃	nhpnhhspn
凄	nhhzhhszph
凅	nhszhsszhh
准	nhpsnhhhsh
凇	nhhspnpnzn
凈	nhpnnpzhhs
凉	nhnhszhspn
凊	nhhhshszhh
凋	nhpzhshszh
凌	nhhshpnpzn
减	nhhphszhzpn
凐	nhhszsshhsh
凑	nhhhhpnhhpn
凒	nhszshszhnph
凓	nhhszsshhspn
凕	nhnzszhhnhpn
凖	nhpsnhhhshhs
凗	nhszspsnhhhsh
凘	nhhsshhhpnpphs
凛	nhnhszszhhhhspn
凝	nhpzpsspnznzshpn
几	pz
凡	pzn
凤	pzzn
凥	zhppz
凫	pznzpz
凭	psphshpz
凯	szszhzpz
凰	pzpszhhhhsh
凳	znppnhszhnphpz
凶	pnzs
凸	shszh
凹	szszh
出	zsszs
击	hhszs
函	zsnhpnzs
凿	ssnphnphhszs
刀	zp
刁	zh
刃	zpn
刄	zpn
刅	zpnn
分	pnzp
切	hzzp
刉	phzss
刊	hhsss
刍	pzzhh
刎	pzppss
刑	hhpsss
划	hzpnss
列	hpznss
刘	nhpnss
则	szpnss
刚	szpnss
创	pnzzss
刜	zhzpsss
初	nzspnzp
刟	zpszhss
删	pzpzhss
判	nphhpss
別	szhzpss
刧	hshznzp
刨	pzzhzss
利	phspnss
刪	szsshss
别	szhzpss
刬	hhzpnss
刭	znhshss
刮	phsszhss
刯	hszhhhss
到	hznhshss
制	phhszsss
刷	zhpszsss
券	nphhpnzp
刹	pnhspnss
刺	hszspnss
刻	nhzppnss
刼	hshznzpn
刽	pnhhznss
剀	szszhzss
剁	pzhspnss
剈	szhszhhss
剉	pnpnhshss
削	snpszhhss
剋	hsszhpzss
剌	hszhspnss
前	nphszhhss
剎	pnhspnnss
剐	szhszpnss
剑	pnhnnphss
剔	szhhpzppss
剖	nhnphszhss
剜	nnzpznzzss
剥	zhhsnhpnss
剩	phsshhpzpnss
剪	nphszhhsszp
剬	szshpszssss
副	hszhszhshss
割	nnzhhhsszhss
劈	zhpszhnhnphhszp
力	zp
劝	znzp
办	zpnn
功	hshzp
加	zpszh
务	pznzp
劣	spnpzp
劤	pphszp
劥	nhpzzp
劦	zpzpzp
动	hhznzp
助	szhhhzp
努	zphznzp
劫	hshznzp
劭	zpszhzp
劮	phhpnzp
励	hphzpzp
劲	znhshzp
劳	hssnzzp
効	nhpnpnzp
劽	hpznsszp
劾	nhzppnzp
势	hshpznzp
勀	hsszhpzzp
勁	hzzzhshzp
勂	phshszhzp
勃	hsnzzshzp
勆	nzhhznzp
勇	znszhhszp
勉	pzszhpzzp
勊	hsszhpzzp
勋	szhszpnzp
勒	hsshszhhszp
勘	hsshhhpnzzp
募	hssszhhhpnzp
勠	znhznhpnpppzp
勺	pzn
勾	pzzn
勿	pzpp
匀	pznh
匃	pzpnz
包	pzzhz
匆	pzppn
匈	pzpnzs
匋	pzphhszs
匍	pzhszhhsn
匎	pzhpnszhhz
匐	pzhszhszhsh
匑	pzpszhhhpzhz
匕	pz
化	pspz
北	shhpz
匙	szhhhshpnpz
匛	hpznz
匝	hszsz
匠	hpphsz
匡	hhhshz
匢	hpzppz
匣	hszhhsz
匤	hhhshnz
匥	hznhpsz
匪	hshhhshhhz
匹	hpzz
区	hpnz
医	hphhpnz
匼	hpnhszhz
匽	hszhhzphz
匾	hnzhpszhssz
匿	hhsshpszhz
十	hs
卂	zhs
千	phs
卅	hpss
卆	pzhs
升	phps
午	phhs
卉	hshps
半	nphhs
卋	hshssh
华	pspzhs
协	hszpnn
卑	pszhhphs
卒	nhpnpnhs
卓	shszhhhs
单	npszhhhs
卖	hsznnhpn
南	hssznphhs
単	nnpszhhhs
卙	hsshhhpnzhs
博	hshszhhsnhsn
卜	sn
卞	nhsn
卟	szhsn
占	shszh
卡	shhsn
卢	shzhp
卣	shszzhh
卤	shszpnh
卦	hshhshsn
卧	hszhszsn
卨	shszzszszh
卫	zsh
卬	pzzs
卭	hshzs
卮	pphzz
卯	pzpzs
印	pzhzs
危	pzhpzz
卲	zpszhzs
即	zhhznzs
却	hshznzs
卵	pznpzsn
卷	nphhpnzz
卸	phhshshzs
卹	pszsshzs
卻	pnpnszhzs
卾	szhszhhhzzs
卿	pzpzhhznzs
厂	hp
厄	hpzz
厅	hphs
历	hpzp
厇	hpphz
厈	hphhs
厉	hphzp
压	hphshn
厌	hphpnn
厏	hpphshh
厐	hphpzpn
厒	hpphhszs
厓	hphshhsh
厔	hphznhsh
厕	hpszpnss
厖	hphpzpppn
厗	hpnhnphhs
厘	hpszhhshh
厙	hphszhhhs
厚	hpszhhzsh
厜	hpphshsshh
厝	hphsshszhh
厞	hpshhhshhh
原	hppszhhspn
厡	hppszhhszpn
厢	hphspnszhhh
厥	hpnphzsppzpn
厦	hphpszhhhpzn
厨	hphszhnphhsn
厩	hpzhhznhzpz
厫	hphhshzpphpn
厷	hpzn
厹	pzzn
厺	hpnzn
去	hshzn
厾	zhshzn
县	szhhhzn
叁	znhpnhhh
参	znhpnppp
又	zn
叉	znn
及	pzn
友	hpzn
双	znzn
反	ppzn
发	zpznn
叔	shhspnzn
取	hsshhhzn
受	pnnpnzzn
变	nhsspnzn
叙	pnhhspnzn
叛	nphhpppzn
叞	zhphhspnzn
叟	pshzhhszn
叠	znznznnzszhhh
口	szh
古	hsszh
句	pzszh
另	szhzp
叧	szhzp
叨	szhzp
叩	szhzs
只	szhpn
叫	szhzs
召	zpszh
叭	szhpn
叮	szhhs
可	hszhs
台	znszh
叱	szhpz
史	szhpn
右	hpszh
叴	pzszh
叵	hszhz
叶	szhhs
号	szhhz
司	zhszh
叹	szhzn
叺	szhpn
叻	szhzp
叼	szhzh
叽	szhpz
叾	zsszh
叿	szhhsh
吀	szhphs
吁	szhhhs
吂	nhzszh
吃	szhphz
各	pznszh
吆	szhzzn
吇	szhzsh
合	pnhszh
吉	hshszh
吊	szhszs
吋	szhhsn
同	szhszh
名	pznszh
后	pphszh
吏	hszhpn
吐	szhhsh
向	pszszh
吒	szhphz
吓	szhhsn
吔	szhzsz
吕	szhszh
吖	szhnps
吗	szhzzh
吘	szhphhs
吙	szhnppn
吚	szhzhhp
君	zhhpszh
吜	szhzshh
吝	nhpnszh
吞	hhpnszh
吟	szhpnnz
吠	szhhpnn
吡	szhhzpz
吢	nznnszh
吣	szhnznn
吤	szhpnps
吥	szhhpsn
否	hpsnszh
吧	szhzshz
吨	szhhzsz
吩	szhpnzp
吪	szhpspz
含	pnnzszh
听	szhpphs
吭	szhnhpz
吮	szhznpz
启	nzhpszh
吰	szhhpzn
吱	szhhszn
吲	szhzhzs
吴	szhhhpn
吵	szhspnp
吶	szhszpn
吷	szhzhpn
吸	szhpzn
吹	szhpzpn
吺	szhpzzn
吻	szhpzpp
吼	szhzshz
吽	szhphhs
吾	hszhszh
吿	phhsszh
呀	szhhzsp
呁	szhpznh
呃	szhhpzz
呄	zphsszh
呅	szhnhpn
呆	szhhspn
呇	szpnszh
呈	szhhhsh
告	phshszh
呋	szhhhpn
呌	szhnnhs
呍	szhhhzn
呎	szhzhpn
呏	szhphps
呐	szhszpn
呑	phpnszh
呒	szhhhpz
呓	szhhssz
呔	szhhpnn
呕	szhhpnz
呖	szhhpzp
呗	szhszpn
员	szhszpn
呙	szhszpn
呛	szhpnzz
呜	szhpzzh
呡	szhzhzhz
呢	szhzhppz
呣	szhzznhn
呤	szhpnnzn
呥	szhszshh
呦	szhzznzp
呧	szhpzhzn
周	pzhshszh
呯	szhhnphs
呰	shshpzszh
呱	szhppznn
呲	szhshshpz
味	szhhhspn
呴	szhpzszh
呵	szhhszhs
呶	szhzphzn
呷	szhszhhs
呸	szhhpsnh
呻	szhszhhs
呼	szhpnphs
命	pnhszhzs
呾	szhszhhh
呿	szhhshzn
咁	szhhsshh
咂	szhhszsz
咄	szhzsszs
咅	nhnphszh
咆	szhpzzhz
咇	szhnznpn
咈	szhzhzps
咉	szhszhpn
咊	szhphspn
咋	szhphshh
和	phspnszh
咍	szhznszh
咎	pznsnszh
咏	szhnzzpn
咐	szhpshsn
咒	szhszhpz
咔	szhshhsn
咕	szhhsszh
咖	szhzpszh
咘	szhhpszs
咙	szhhpzpn
咚	szhpznnn
咛	szhnnzhs
咜	szhnnzpz
咝	szhzzzzh
咞	szhhhps
咠	szhhsshhh
咡	szhhsshhh
咢	szhszhhhz
咣	szhsnphpz
咤	szhnnzphz
咥	szhhznhsh
咦	szhhzhzpn
咧	szhhpznss
咨	nhpzpnszh
咩	szhnphhhs
咪	szhnphspn
咫	zhpnszhpn
咬	szhnhpnpn
咭	szhhshszh
咯	szhpznszh
咱	szhpszhhh
咲	szhnphhpn
咳	szhnhzppn
咵	szhhpnhhz
咸	hphszhzpn
咹	szhnnzzph
咺	szhhszhhh
咻	szhpshspn
咽	szhszhpnh
咿	szhpszhhp
哀	nhszhpzpn
品	szhszhszh
哂	szhhszpzh
哃	szhszhszh
哄	szhhsshpn
哅	szhpzpnzs
哆	szhpznpzn
哇	szhhshhsh
哈	szhpnhszh
哉	hshszhzpn
响	szhpszszh
哎	szhhsspn
哏	szhzhhzpn
哐	szhhhhshz
哑	szhhssnph
哒	szhhpnnzn
哓	szhhzphpz
哔	szhhzpzhs
哚	szhpzhspn
哜	szhnhpnps
哝	szhnzpzpn
哞	szhznphhs
哟	szhzzhpzn
哠	szhphshszh
哢	szhhhshhps
哣	szhhszhnph
哤	szhhpzpppn
哥	hszhshszhs
哦	szhphshzpn
哧	szhhshpspn
哨	szhsnpszhh
哩	szhszhhshh
哪	szhzhhpzs
哭	szhszhhpnn
哮	szhhshpzsh
哯	szhszhhhpz
哰	szhnnzphhs
哱	szhhsnzzsh
哲	hshpphsszh
哳	szhhshpphs
哴	szhnzhhzpn
哺	szhhszhhsn
哻	szhszhhhhs
哼	szhnhszhzs
哽	szhhszhhpn
哾	szhnpszhpz
唅	szhpnnzszh
唆	szhznpnpzn
唇	hphhzpnszh
唏	szhpnhpszs
唐	nhpzhhsszh
唑	szhpnpnhsh
唒	szhhszpzhh
唔	szhhszhszh
唛	szhhhshpzn
唝	szhhshszpn
唠	szhhssnzzp
唡	szhhszpnpn
唢	szhsnpszpn
唣	szhpszhhhz
唤	szhpzszhpn
唧	szhzhhznzs
唨	szhzsszhhh
唩	szhphspnzph
唪	szhhhhpnhhs
唫	szhpnhhsnph
唬	szhshzphzpz
唭	szhhsshhhpn
售	psnhhhshszh
唯	szhpsnhhhsh
唰	szhzhpszsss
唱	szhszhhszhh
唳	szhnzhphpnn
唵	szhhpnszhhz
唶	szhhsshszhh
唷	szhnhznszhh
唸	szhpnnznznn
唺	szhszhsshpn
唽	szhhspnpphs
唾	szhphshsshh
唿	szhpzppnznn
啀	szhhphshhsh
啁	szhpzhshszh
啂	szhpnnpzshz
啃	szhshshszhh
啄	szhhpzppnpn
啅	szhshszhhhs
商	nhnpszpnszh
啇	nhnpszhsszh
啈	szhhshnphhs
啉	szhhspnhspn
啊	szhzshszhs
啌	szhnnzpnhsh
啍	szhnhszhzsh
啐	szhnhpnpnhs
啑	szhhzhhshpn
啓	nzhpphpnszh
啕	szhpzphhszs
啗	szhpzpshzhh
啘	szhnnzpznzz
啛	szhhzhhszph
啜	szhznznznzn
啡	szhshhhshhh
啣	szhphhshshzs
啤	szhpszhhphs
啥	szhpnhhsszh
啦	szhhshnhnph
啧	szhhhshszpn
啨	szhhhshszhh
啪	szhhshpszhh
啫	szhhshpszhh
啬	hsnphszszhh
啮	szhshshpnzs
啯	szhszhhshnh
啰	szhszsshpzn
啵	szhnnhzpszn
啷	szhnzhhznzs
啸	szhzhhspspn
啻	nhnpnzszsszh
啼	szhnhnpnzszs
啾	szhphspnnppn
啿	szhhsshhhpnz
喀	szhnnzpznszh
喂	szhszhshhzpn
喃	szhhssznphhs
善	nphhhsnphszh
喅	szhszhhnhnph
喆	hshszhhshszh
喇	szhhszhspnss
喈	szhhzpzpszhh
喉	szhpszhphhpn
喊	szhhphszhzpn
喋	szhhsshzhspn
喏	szhhsshpszh
喐	szhhpszhhzs
喑	szhnhnphszhh
喒	szhpznsnszhh
喓	szhhszsshzph
喔	szhzhphznhsh
喖	szhhspnhsszh
喘	szhszshpszss
喙	szhzzhpzpppn
喛	szhpnnphhpzn
喜	hshszhnphszh
喝	szhszhhpzpnz
喟	szhszhshszhh
喧	szhnnzhszhhh
喫	szhhhhszphpn
喱	szhhpszhhshh
喳	szhhspnszhhh
喵	szhhssszhsh
喷	szhhshssszpn
喻	szhpnhszhhss
喽	szhnphspnzph
嗄	szhhpszhhhpzn
嗅	szhpszhhhhpnn
嗇	hspnpnhszszhh
嗍	szhnphzsppzhh
嗏	szhhsspnhspn
嗐	szhnnzhhhsszh
嗑	szhhshznszssh
嗓	szhznznznhspn
嗔	szhhsszhhhhpn
嗖	szhpshzhhszn
嗗	szhszznzszhh
嗛	szhnphzhhsspn
嗜	szhhshppzszhh
嗝	szhhszhsznphs
嗞	szhnphzznzzn
嗟	szhnphhhphsh
嗡	szhpnznznhznh
嗢	szhszhhszssh
嗣	szhszhsszhszh
嗤	szhzsshszhshn
嗥	szhpszhhhpnhs
嗦	szhhsnzzznspn
嗧	zpszhpnhszhss
嗨	szhnnhphzznhn
嗪	szhhhhpnphspn
嗫	szhhsshhhznzn
嗬	szhhsspshszhs
嗯	szhszhpnhnznn
嗳	szhpnnpnzhpzn
嗷	szhhhshzpphpn
嗸	hhshzpphpnszh
嗺	szhszspsnhhhsh
嗼	szhhssszhhhpn
嗽	szhhszhspnpzpn
嘃	szhnhpzhhszhhs
嘅	szhzhhznhzpz
嘈	szhhszhsshszhh
嘉	hshszhnphzpszh
嘍	szhszhhszhszph
嘎	szhhpszhhhhzpn
嘖	szhhhshszhhhpn
嘘	szhshzphzssnph
嘙	szhnnhzpsznzph
嘚	szhppsszhhhhsn
嘛	szhnhphspnhspn
嘞	szhhsshszhhszp
嘟	szhhshpszhhzs
嘬	szhszhhhsshhhzn
嘭	szhhshszhnphppp
嘱	szhzhppszhszshn
嘲	szhhsszhhhspzhh
嘴	szhshshpzpzpzhhs
嘶	szhhsshhhpnpphs
噓	szhshzphzsszshh
噘	szhhpnphzsppzpn
噜	szhpzszhshhszhh
噢	szhpsznphspnhpn
器	szhszhhpnnszhszh
噩	hsszhszhhszhszhh
噪	szhszhszhszhhspn
噫	szhnhnphszhhnznn
噬	szhphnphnhspnpnh
噶	szhhssszhhpzpnz
噻	szhnnzhhsshpnhsh
噼	szhzhpszhnhnphhs
嚁	szhznhznhpsnhhhsh
嚎	szhnhszhnzhpzpppn
嚓	szhnnzpznnznhhspn
嚔	szhhsnzszhshznshpn
嚕	szhpzszhshnnnnszhh
嚗	szhszhhhsshpnsnhpn
嚯	szhhnzsnnnnpsnhhhsh
嚷	szhnhszhszhhhsshpzpn
嚾	szhhssszhszhpsnhhhsh
囗	szh
囚	szpnh
四	szpzh
囜	szznh
囝	szzshh
回	szszhh
囟	pszpnh
因	szhpnh
囡	szzphh
团	szhsph
団	szhsnh
囤	szhzszh
囥	sznhpzh
囦	szszpnh
囨	szhpsnh
囩	szhhznh
囪	pszppnh
囫	szpzpph
囬	szsshhh
园	szhhpzh
囯	szhhshh
困	szhspnh
囱	pszpznh
围	szhhzsh
囵	szpnpzh
囷	szphspnh
囸	szhshshh
囹	szpnnznh
固	szhsszhh
国	szhhshnh
图	szpznnnh
囿	szhpszhhh
圃	szhszhhsnh
圄	szhszhszhh
圆	szszhszpnh
圔	szhshznszsshh
土	hsh
圢	hshhs
圣	znhsh
圤	hshsn
圦	hshpn
圧	hphsh
在	hpshsh
圩	hshhhs
圪	hshphz
圫	hshphz
圬	hshhhz
圭	hshhsh
圮	hshzhz
圯	hshzhz
地	hshzsz
圲	hshphs
圳	hshpss
圴	hshpzn
圶	hpnhsh
圸	hshszs
圹	hshnhp
场	hshzpp
圻	hshpphs
圼	szhhhsh
圽	hshpzpp
圾	hshpzn
圿	hshpnps
址	hshshsh
坁	hshpzhz
坂	hshppzn
坃	hshhhpz
坄	hshpzzn
坅	hshpnnz
坆	hshphpn
均	hshpznh
坈	hshnzpz
坉	hshhzsz
坊	hshnhzp
坋	hshpnzp
坌	pnzphsh
坍	hshpznh
坎	hshpzpn
坏	hshhpsn
坐	pnpnhsh
坑	hshnhpz
坒	hzpzhsh
块	hshzhpn
坚	ssznhsh
坛	hshhhzn
坜	hshhpzp
坝	hshszpn
坞	hshpzzh
坟	hshnhpn
坠	zspnhsh
坡	hshzpszn
坢	hshnphhs
坤	hshszhhs
坥	hshszhhh
坦	hshszhhh
坨	hshnnzpz
坩	hshhsshh
坪	hshhnphs
坬	hshppznn
坯	hshhpsnh
坳	hshzznzp
坴	hshpnhsh
坷	hshhszhs
坸	hshpzszh
垂	phshsshh
垃	hshnhnph
垄	hpzpnhsh
垅	hshhpzpn
垈	pshznhsh
垊	hshzhzhz
型	hhpssshsh
垌	hshszhszh
垒	znznznhsh
垓	hshnhzppn
垘	hshpshpnn
垛	hshpzhspn
垝	hshpzhpzz
垞	hshnnzphz
垠	hshzhhzpn
垡	pshzpnhsh
垢	hshpphszh
垣	hshhszhhh
垤	hshhznhsh
垥	hshpnhszh
垦	zhhzpnhsh
垧	hshpszszh
垨	hshnnzhsn
垩	hssnphhsh
垪	hshnphhps
垫	hshpznhsh
垯	hshhpnnzn
垾	hshszhhhhs
垿	hshnhpznzs
埅	zsnhzphsh
埊	szsszpnhsh
埌	hshnzhhzpn
埍	hshszhszhh
城	hshhpzzpn
埑	hshpphshsh
埒	hshpnnphsn
埓	hshpnnphsn
埔	hshhszhhsn
埚	hshszhszpn
埝	hshpnnznznn
埞	hshnnzhshpn
域	hshhszhhzpn
埠	hshpszhzhhs
埢	hshnphhpnzz
埣	hshnhpnpnhs
埤	hshpszhhphs
埥	hshhhshszhh
埦	hshnnzpznzz
埧	hshszhhhhpn
埩	hshpzzhhs
埪	hshnnzpnhsh
埫	hshsnpszszh
埮	hshnppnnppn
埯	hshhpnszhhz
埰	hshpnnphspn
埵	hshphshsshh
埶	hshpnhshpzn
執	hshnphhspzn
埸	hshszhhpzpp
培	hshnhnphszh
基	hsshhhpnhsh
埻	hshnhszhzsh
埼	hshhpnhszhs
埽	hshzhhnzszs
埾	hsshhhznhsh
埿	nnhzhppzhsh
堀	hshzhpzsszs
堁	hshszhhhspn
堂	snpnzszhhsh
堃	nhzpnhzphsh
堄	hshpshzhhpz
堆	hshpsnhhhsh
堇	hsshszhhhsh
堊	hshzzhshhsh
堐	hshhphshhsh
堑	hzshpphshsh
堒	hshszhhhzpz
堔	hshnzpnhspn
堕	zshpszhhhsh
堖	hshzzzpszpnh
堛	hshhszhszhsh
堡	psszhhspnhsh
堣	hshszhhszshn
堤	hshszhhhshpn
堦	hshhzpzpszhh
堨	hshszhhpzpnz
堩	hshnnshszhhh
堪	hshhsshhhpnz
堬	hshpnhszhhss
堭	hshpszhhhhsh
堮	hshszhszhhhz
堯	hshhshhshhpz
堰	hshhszhhzphz
堲	zhhznzshsh
堳	hshzshpszhhh
堵	hshhshpszhh
堾	hshhhhpnszhh
塀	hshzhpnphhps
塇	hshnnzhszhhh
塈	zhhznhzpzhsh
塌	hshszhhznhznh
塎	hshnnzpnpnszh
塑	nphzsppzhhhsh
塔	hshhsspnhszh
塕	hshpnznznhznh
塖	hshphsshhpzpn
塗	nnhpnhhspnhsh
塘	hshnhpzhhsszh
塙	hshnhszhszszh
塚	hshnzhpzppnpn
塜	hshnzhhpzpppn
塝	hshnhnpnznhzp
塞	nnzhhsshpnhsh
塟	hsshpznpzhsh
塠	hshpszhzhnzn
塥	hshhszhsznphs
塧	hshnphpnszssh
填	hshhsszhhhhpn
塬	hshhppszhhspn
塭	hshszhhszssh
塮	hshpszhhhphsn
塯	hshpznzpszhsh
塰	nnhphzznhnhsh
塱	nzhhznpzhhhsh
塴	hshszspzhhpzhh
塸	hshhszhszhszhz
塻	hshhssszhhhpn
塾	nhszhzshpznhsh
境	hshnhnphszhhpz
墅	szhhshhznzshsh
墈	hshhsshhhpnzzp
墉	hshnhpzhhszhhs
墐	hshhsshszhhhsh
墑	hshnhnpszhsszh
墒	hshnhnpszpnszh
墓	hssszhhhpnhsh
墙	hshhsnphszszhh
墜	zsnphpzpppnhsh
增	hshnpszsnphszhh
墟	hshshzphzssnph
墡	hshnphhhsnphszh
墣	hshssnphnphhhpn
墦	hshpnphspnszhsh
墨	sznphshhnnnnhsh
墩	hshnhszhzshphpn
墪	nhszhzshphpnhsh
墫	hshnphszpzhhhsn
墬	zszzhpzpppnhsh
墴	hshhsshszhshpn
墻	hshhspnpnhszszhh
墽	hshpszhhnhzpphpn
壀	hshzhpszhnhnphhs
壁	zhpszhnhnphhshsh
壂	zhphsshpnpzznhsh
壃	hshhszhshhszhshh
壅	nhzzppsnhhhshhsh
壇	hshnhszszhhszhhh
壈	hshnhszszhhphspn
壑	shnzhpnpnszhznhsh
壕	hshnhszhnzhpzpppn
壖	hshhnzsnnnnhpszss
壤	hshnhszhszhhhsshpzpn
士	hsh
壬	phsh
壮	nhshsh
声	hshzshp
壱	hshnzpz
壳	hshnzpz
壶	hshnzssnph
壸	hshnzhssnph
壹	hshnzhszhnph
壻	hshzshpnszhh
壿	hshnphszpzhhhsn
处	pznsn
夆	pznhhhs
备	pznszhsh
夈	pznnphspn
夌	hshpnpzn
复	phszhhpzn
夏	hpszhhhpzn
夕	pzn
外	pznsn
夗	pznzz
夘	pznzs
夙	pzhpzn
多	pznpzn
夜	nhpspznn
够	pzszhpznpzn
夠	pznpznpzszh
夤	pznnnzhszhshpn
大	hpn
天	hhpn
太	hpnn
夫	hhpn
夬	zhpn
夭	phpn
央	szhpn
夯	hpnzp
夰	hpnps
失	phhpn
夲	hpnhs
夳	hpnhh
头	nnhpn
夷	hzhzpn
夸	hpnhhz
夹	hnphpn
夺	hpnhsn
夻	hpnszh
夼	hpnpss
奂	pzszhpn
奄	hpnszhhz
奇	hpnhszhs
奈	hpnhhspn
奉	hhhpnhhs
奋	hpnszhsh
奎	hpnhshhsh
奏	hhhpnhhpn
奐	pzszpnhpn
契	hhhszphpn
奔	hpnhshps
奕	nhpspnhps
奖	nhspznhpn
套	hpnhshhhzn
奘	zshphshhpn
奚	pnnpzznhpn
奜	shhhshhhhpn
奠	nphszpzhhhpn
奢	hpnhshpszhh
奥	psznphspnhpn
奧	pszpnphspnhpn
女	zph
奴	zphzn
奵	zphhs
奶	zphzp
奷	zphphs
奸	zphhhs
她	zphzsz
奼	zphphz
好	zphzsh
好	zphzh
奿	pznzph
妁	zphpzn
如	zphszh
妃	zphzhz
妄	nhzzph
妅	zphhsh
妆	nhszph
妇	zphzhh
妈	zphzzh
妉	zphnzpz
妊	zphphsh
妋	zphhhpn
妌	zphhhps
妍	zphhhps
妎	zphpnps
妏	zphnhpn
妒	zphnzhp
妓	zphhszn
妖	zphphpn
妙	zphspnp
妞	zphzshh
妟	szhhzph
妠	zphszpn
妣	zphhzpz
妤	zphznzs
妥	pnnpzph
妦	zphhhhs
妧	zphhhpz
妨	zphnhzp
妩	zphhhpz
妪	zphhpnz
妮	zphzhppz
妯	zphszhsh
妰	zphphshh
妱	zphzpszh
妲	zphszhhh
妴	pzpzzzph
妷	zphphhpn
妹	zphhhspn
妺	zphhhspn
妻	hzhhszph
妼	zphnznpn
妾	nhnphzph
妿	zpszhzph
姀	zphphspn
姁	zphpzszh
姂	zphpnzn
姄	zphzhzhz
姅	zphnphhs
姆	zphzznhn
姈	zphpnnzn
姍	zphszssh
姎	zphszhpn
姏	zphhsshh
姐	zphszhhh
姑	zphhsszh
姓	zphphhsh
委	phspnzph
姕	shshpzzph
姖	zphhzhz
姗	zphpzpzh
姘	zphnphhps
姚	zphpnhzpn
姛	zphszhszh
姜	nphhshzph
姝	zphphhspn
姣	zphnhpnpn
姤	zphpphszh
姥	zphhshppz
姨	zphhzhzpn
姮	zphhszhhh
姰	zphpzszhh
姵	zphpzhszs
姸	zphhhphhs
姹	zphnnzphz
姺	zphphshpz
姻	zphszhpnh
姿	nhpzpnzph
威	hphzphzpn
娃	zphhshhsh
娄	nphspnzph
娅	zphhssnph
娆	zphhzphpz
娇	zphphpnps
娈	nhsspnzph
娉	zphszhshhz
娑	nnhspnpzph
娒	zphphzznhn
娓	zphzhpphhz
娘	zphnzhhzpn
娜	zphzhhpzs
娟	zphszhszhh
娥	zphphshzpn
娧	zphnpszhpz
娨	zphszhhhhs
娩	zphpzszhpz
娪	zphhszhszh
娱	zphszhhhpn
娲	zphszhszpn
娴	zphnszhspn
娶	hsshhhznzph
娼	zphszhhszhh
婀	zphzshszhs
婂	zphpszhhszs
婃	zphnnzhhspn
婄	zphnhnphszh
婆	nnhzpsznzph
婈	zphhshpnpzn
婉	zphnnzpznzz
婊	zphhhshpzpn
婐	zphszhhhspn
婑	zphphspnzph
婓	shhhshhhzph
婔	zphshhhshhh
婕	zphhzhhshpn
婚	zphpzhzszhh
婝	zphnnzhshpn
婞	zphhshnphhs
婠	zphnnzszhzh
婢	zphpszhhphs
婤	zphpzhshszh
婥	zphshszhhhs
婧	zphhhshszhh
婪	hspnhspnzph
婫	zphszhhhzpz
婴	szpnszpnzph
婵	zphnpszhhhs
婶	zphnnzszhhs
婷	zphnhszhnzhs
婺	znzspphpnzph
婻	zphhssznphhs
婼	zphhsshpszh
婿	zphzshpnszhh
媏	zphszshpszss
媒	zphhsshhhspn
媓	zphpszhhhhsh
媚	zphzshpszhhh
媛	zphpnnphhpzn
媳	zphpszhhhnznn
媴	zphhshszhpzpn
媷	zphhphhzpnhsn
媾	zphhhsshszshh
嫁	zphnnzhpzpppn
嫂	zphpshzhhszn
嫋	zphzhznhzhznh
嫌	zphnphzhhsspn
嫎	zphnhnpnznhzp
嫏	zphnzhhznzs
嫔	zphnnzpshshpn
嫖	zphhszsshhhspn
嫦	zphsnpnzszhszs
嫩	zphhszhspnphpn
嫱	zphhsnphszszhh
嬉	zphhshszhnphszh
孄	zphszhhszhhhsznphspn
子	zsh
孑	zsh
孓	zsn
孔	zshz
孕	zpzsh
孖	zshzsh
字	nszzsh
存	hpszsh
孙	zshspn
孚	pnnpzsh
孛	hsnzzsh
孜	zshphpn
孝	hshpzsh
孟	zshszssh
孢	zshpzzhz
季	phspnzsh
孤	zshppznn
学	nnpnzzsh
孩	zshnhzppn
孪	nhsspnzsh
孬	hpsnzphzsh
孰	nhszhzshpzn
孱	zhpzshzshzsh
孳	nphzznzznzsh
孵	pznpzsnpnnpzsh
孹	zhpszhnhnphhszsh
孺	zshhnzsnnnnhpszss
孽	hsspszhzhnhnphhszsh
孿	nhhhszhzznnnnzznnnnzsh
宁	nnzhs
宂	nnzpz
它	nnzpz
宅	nnzphz
宇	nnzhhs
守	nnzhsn
安	nnzzph
宋	nnzhspn
完	nnzhhpz
宏	nnzhpzn
宕	nnzhpszh
宖	nnzzhzzn
宗	nnzhhspn
官	nnzszhzh
宙	nnzszhsh
定	nnzhshpn
宛	nnzpznzz
宜	nnzszhhh
宝	nnzhhshn
实	nnznnhpn
宠	nnzhpzpn
审	nnzszhhs
客	nnzpznszh
宣	nnzhszhhh
室	nnzhznhsh
宥	nnzhpszhh
宦	nnzhszhsz
宧	nnzhsszhsz
宪	nnzphshpz
宫	nnzszhszh
宰	nnznhnphhs
害	nnzhhhsszh
宵	nnzsnpszhh
家	nnzhpzpppn
宸	nnzhphhzpn
容	nnzpnpnszh
宼	nnzhhpzzph
宽	nnzhssszpz
宾	nnzpshshpn
宿	nnzpshpszhh
寂	nnzshhspnzn
寃	nnzpzszhpzn
寄	nnzhpnhszhs
寅	nnzhszhshpn
密	nnznznpnszs
寇	nnzhhpzshzn
寋	nnzhhsshpnzz
富	nnzhszhszhsh
寐	nnzzshphhspn
寒	nnzhhsshpnnn
寓	nnzszhhszshn
寝	nnznhszhhnzzn
寞	nnzhssszhhhpn
察	nnzpznnznhhspn
寡	nnzhpszhhhpnzp
寢	nnzzshpzhhnzzn
寥	nnzznhznhpnppp
寨	nnzhhsshpnhspn
寸	hsn
对	znhsn
寺	hshhsn
寻	zhhhsn
导	zhzhsn
寽	pnnphsn
寿	hhhphsn
封	hshhshhsn
尃	hszhhsnhsn
射	pszhhhphsn
尅	hsszhpzhsn
将	nhspznhsn
尉	zhphhspnhsn
尊	nphszpzhhhsn
小	spn
少	spnp
尓	phspn
尘	spnhsh
尚	snpszszh
尝	snpnzhhzn
尞	hpnnpszhhspn
尠	hsshhhpnzspnp
尡	snphpzszhhhzpz
尤	hpzn
尧	hzphpz
尨	hpzpppn
尬	hpzpnps
就	nhszhspnhpzn
尴	hpzssphnszssh
尸	zhp
尹	zhhp
尺	zhpn
尻	zhppz
尼	zhppz
尽	zhpnnn
尾	zhpphhz
尿	zhpszpn
局	zhpzszh
屁	zhphzpz
层	zhphhzn
屃	zhpszpn
屄	zhpnnzpn
居	zhphsszh
屈	zhpzsszs
屉	zhphsshz
届	zhpszhsh
屋	zhphznhsh
屌	zhpszhszs
屎	zhpnphspn
屏	zhpnphhps
屐	zhpppshszn
屑	zhpsnpszhh
屒	zhphphhzpn
屔	pshshzhppz
展	zhphsshzpn
屖	zhpnhnphhs
屙	zhpzshszhs
屝	zhpshhhshhh
属	zhppszhszshn
屠	zhphshpszhh
屡	zhpnphspnzph
屣	zhpppsshshshpn
屦	zhpppsnphspnzph
屯	hzsz
山	szs
屿	szshzh
岀	szsszs
岁	szspzn
岂	szszhz
岇	szspzzs
岌	szspzn
岑	szspnnz
岔	pnzpszs
岕	szspnps
岖	szshpnz
岗	szsszpn
岘	szsszpz
岙	phpnszs
岚	szspzpn
岛	pznzszs
岜	szszshz
岝	szsphshh
岡	sznphszs
岢	szshszhs
岩	szshpszh
岭	szspnnzn
岰	szszznzp
岱	pshznszs
岳	pshshszs
岷	szszhzhz
岸	szshphhs
岺	szspnnzn
岻	szspzhzn
岿	szsspzhh
峁	szspzpzs
峋	szspzszhh
峌	szshznhsh
峎	szszhhzpn
峒	szsszhszh
峛	szshpznss
峡	szshnphpn
峢	szshpznss
峥	szspzzhhs
峦	nhsspnszs
峧	szsnhpnpn
峨	szsphshzpn
峪	szspnpnszh
峭	szssnpszhh
峰	szspznhhhs
峳	szspssphpn
峷	szsnhnphhs
峼	szsphshszh
峽	szshpnpnpn
峾	nnhpphsszs
崂	szshssnzzp
崃	szshnphspn
崇	szsnnzhhspn
崈	nnzhhspnszs
崑	szsszhhhzpz
崒	szsnhpnpnhs
崓	szsszhsszhh
崔	szspsnhhhsh
崖	szshphshhsh
崗	szssznphszs
崙	szspnhszhss
崟	szspnhhsnph
崤	szspnhpszhh
崧	szshspnpnzn
崩	szspzhhpzhh
崭	szshzshpphs
崮	szsszhsszhh
崴	szshphzphzpn
崽	szsszhshnznn
嵁	szshsshhhpnz
嵆	phspnhpznszs
嵇	phspnhpznszs
嵋	szszshpszhhh
嵌	szshsshhpzpn
嵘	szshssnzhspn
嵝	szsnphspnzph
嵩	szsnhszhszszh
嵿	szshshpszhhhpn
嶅	hhshzpphpnszs
嶎	szszhphhspnhsn
嶝	szsznppnhszhnph
嶭	szspszhzhnhnphhs
巍	szsphspnzphpszhhpzzn
川	pss
州	npnsns
巟	nhzpsz
巡	zzznzn
巢	zzzszhhhspn
工	hsh
左	hphsh
巧	hshhz
巨	hzhz
巩	hshpzn
巫	hspnpnh
差	nphhhphsh
巯	znhshnhznpsz
己	zhz
已	zhz
巳	zhz
巴	zshz
巵	pphzshz
巶	zpszhzhz
巷	hsshpnzhz
巸	hsszhszzhz
巽	zhzzhzhsshpn
巾	szs
巿	hszs
帀	hszs
币	pszs
市	nhszs
布	hpszs
帅	spszs
帆	szspzn
师	sphszs
帏	szshhzs
帐	szsphzn
帑	zphznszs
帒	pshznszs
帕	szspszhh
帖	szsshszh
帘	nnzpnszs
帙	szsphhpn
帚	zhhnzszs
帛	pszhhszs
帜	szsszhpn
帝	nhnpnzszs
帟	nhpspnszs
帠	pshzhhszs
帣	nphhpnszs
带	hsssnzszs
帧	szsshszpn
席	nhphsshszs
帮	hhhpzsszs
帯	hssshnzszs
帷	szspsnhhhsh
常	snpnzszhszs
帼	szsszhhshnh
幂	nzszhhhpnszs
幌	szsszhhsnphpz
幔	szsszhhszsshzn
幕	hssszhhhpnszs
幛	szsnhnphszhhhs
幡	szspnphspnszhsh
幢	szsnhnphszhhshh
幥	szssnpnzszhphhs
幦	zhpszhnhnphhsszs
干	hhs
平	hnphs
年	phhshs
并	nphhps
幸	hshnphhs
幺	zzn
幻	zznz
幼	zznzp
幽	szznzznzs
广	nhp
庄	nhphsh
庆	nhphpn
庇	nhphzpz
床	nhphspn
庎	nhppnps
序	nhpznzs
庐	nhpnzhp
庒	nhphshn
库	nhphzhs
应	nhpnnph
底	nhppzhzn
庖	nhppzzhz
店	nhpshszh
庙	nhpszhsh
庚	nhpzhhpn
庛	nhpshshpz
府	nhppshsn
庞	nhphpzpn
废	nhpzpznn
庠	nhpnphhhs
庤	nhphshhsn
度	nhphsshzn
座	nhppnpnhsh
庭	nhpphshzn
庵	nhphpnszhhz
庶	nhphsshnnnn
康	nhpzhhsnhpn
庸	nhpzhhszhhs
庾	nhppshzhhpn
廂	nhphspnszhhh
廇	nhppznzpszhsh
廈	nhphpszhhhpzn
廉	nhpnphzhhsspn
廊	nhpnzhhznzs
廎	nhphzhpszhhhpn
廖	nhpznhznhpnppp
廘	nhpnhpzsshhzpz
廝	nhphsshhhpnpphs
廟	nhphsszhhhspzhh
廵	zzzzn
延	pshzzn
廷	phshzn
建	zhhhhszn
廿	hssh
开	hhps
弁	znhps
异	zhzhps
弃	nhznhps
弄	hhshhps
弅	pnzphps
弈	nhpspnhps
弊	npszspnphpnhps
弋	hzn
弎	hhhhzn
式	hhshzn
弑	pnhspnhhshzn
弓	zhz
引	zhzs
弗	zhzps
弘	zhzzn
弛	zhzzsz
弟	npzhzsp
张	zhzphzn
弡	zhzhzhz
弥	zhzpzspn
弦	zhznhzzn
弧	zhzppznn
弨	zhzzpszh
弩	zphznzhz
弮	nphhpnzhz
弯	nhsspnzhz
弰	zhzsnpszhh
弱	zhznhzhznh
弲	zhzszhszhh
弴	zhznhszhzsh
弶	zhznhszhspn
弸	zhzpzhhpzhh
弹	zhznpszhhhs
强	zhzszhszhshn
弼	zhzhpszhhzhz
弿	nnzhhsshpnzhz
彀	hshnzhzhzpzzn
彁	zhzhszhshszhs
彆	npszspnphpnzhz
彊	zhzhszhshhszhshh
彌	zhzhpnszspnpnpnpn
归	spzhh
当	snpzhh
彔	zzhsnhpn
录	zhhsnhpn
彖	zzhpzpppn
彗	hhhshhhszhh
彘	zzhphhpnhzpz
彝	zzhnphspnzznspnhps
形	hhpsppp
彤	pznhppp
彦	nhnphpppp
彨	hsznsznppp
彩	pnnphspnppp
彪	shzphzpzppp
彫	pzhshszhppp
彬	hspnhspnppp
彭	hshszhnphppp
彮	nnzpnpnszhppp
彯	hszsshhhspnppp
彰	nhnphszhhhsppp
影	szhhnhszhspnppp
彴	ppspzn
彷	ppsnhzp
彸	ppspnzn
役	ppspzzn
彻	ppshzzp
彼	ppszpszn
彽	ppspzhzn
彾	ppspnnzn
彿	ppszhzps
往	ppsnhhsh
征	ppshshsh
径	ppsznhsh
待	ppshshhsn
徇	ppspzszhh
很	ppszhhzpn
徉	ppsnphhhs
徊	ppsszszhh
律	ppszhhhhs
徎	ppsszhhhsh
徏	ppsshshspp
徐	ppspnhhspn
徒	ppshshshpn
徔	ppshssnzn
徕	ppshnphspn
得	ppsszhhhhsn
徘	ppsshhhshhh
徙	ppsshshshpn
徛	ppshpnhszhs
徜	ppssnpszszh
徝	ppshsszhhhh
徟	ppspzhshszh
御	ppsphhshshzs
徢	ppshzhhshpn
徣	ppshsshszhh
徤	ppszhhhhszn
徥	ppsszhhhshpn
徦	ppszhshhzhzn
徨	ppspszhhhhsh
復	ppsphszhhpzn
循	ppspphsszhhh
徬	ppsnhnpnznhzp
徭	ppspnnpphhszs
微	ppsszshpzphpn
徱	ppshszsshhhspn
徲	ppszhpsnhpnphhs
徳	ppshsszsshnznn
徴	ppsszshhshphpn
徵	ppsszshhhshphpn
徶	ppsnpszspnphpn
德	ppshsszsshhnznn
徸	ppsnhnphszhhshh
徹	ppsnhznszhhphpn
徼	ppspszhhnhzpphpn
徽	ppsszshzznspnphpn
忂	ppsszhhhszhhhpsnhhhsh
心	nznn
必	nznpn
忆	nnsz
忋	nnszhz
忌	zhznznn
忍	zpnnznn
忏	nnsphs
忐	shhnznn
忑	hsnnznn
忒	hnznnzn
忓	nnshhs
忔	nnsphz
忖	nnshsn
志	hshnznn
忘	nhznznn
忙	nnsnhz
忟	nnsnhpn
忠	szhsnznn
忡	nnsszhs
忤	nnsphhs
忥	phhznznn
忧	nnshpzn
忩	pnznnznn
快	nnszhpn
忬	nnsznz
忴	nnspnnz
念	pnnznznn
忶	nnshhzn
忼	nnsnhpz
忽	pzppnznn
忾	nnsphhz
忿	pnzpnznn
怀	nnshpsn
态	hpnnnznn
怂	pnpnnznn
怄	nnshpnz
怅	nnsphzn
怆	nnspnzz
怎	phshhnznn
怏	nnsszhpn
怒	zphznnznn
怔	nnshshsh
怕	nnspszhh
怖	nnshpszs
怜	nnspnnzn
思	szhshnznn
怠	znszhnznn
怡	nnsznszh
急	pzzhhnznn
怦	nnshnphs
性	nnsphhsh
怨	pznzznznn
怪	nnsznhsh
怮	nnszznzp
怯	nnshshzn
怱	pzppnnznn
怵	nnshspnn
总	npszhnznn
恁	psphshnznn
恊	nnszpzpzp
恋	nhsspnnznn
恍	nnssnphpz
恐	hshpznnznn
恑	nnspzhpzz
恒	nnshszhhh
恕	zphszhnznn
恤	nnspszssh
恥	hsshhhnznn
恨	nnszhhzpn
恩	szhpnhnznn
恫	nnsszhszh
恭	hsshpnsnnn
息	pszhhhnznn
恰	nnspnhszh
恳	zhhzpnnznn
恵	hszhhsnznn
恶	hssnphnznn
恷	pshspnnznn
恸	nnshhznzp
恺	nnsszszhz
恻	nnsszpnss
恼	nnsnhpnzs
恽	nnsnzhzhs
恿	znszhhsnznn
悀	nnsznszhhs
悄	nnssnpszhh
悅	nnspnszhpz
悉	pnphspnnznn
悍	nnsszhhhhs
悎	nnsphshszh
悔	nnsphzznhn
悖	nnshsnzzsh
悟	nnshszhszh
悠	pssphpnnznn
患	szhszhsnznn
悦	nnsnpszhpz
悧	nnsphspnss
您	pspzspnnznn
悬	szhhhznnznn
悭	nnsssznhsh
悯	nnsnsznhpn
悲	shhhshhhnznn
悸	nnsphspnzsh
惂	nnspzpshzhh
惃	nnsszhhhzpz
情	nnshhshszhh
惊	nnsnhszhspn
惋	nnsnnzpznzz
惑	hszhhzpnnznn
惓	nnsnphhpnzz
惕	nnsszhhpzpp
惗	nnspnnznznn
惘	nnssznphnhz
惚	nnspzppnznn
惜	nnshsshszhh
惝	nnssnpszszh
惠	hszhhshnnzn
惢	pznnpznnpznn
惦	nnsnhpshszh
惧	nnsszhhhhpn
惨	nnsznhpnppp
惩	ppshshshnznn
惫	pznszhshnznn
惬	nnshhnphpnz
惭	nnshzshpphs
惮	nnsnpszhhhs
惯	nnszzshszpn
惰	nnshphshszhh
想	hspnszhhhnznn
惴	nnsszshpszss
惶	nnspszhhhhsh
惹	hsshpszhnznn
惺	nnsszhhphhsh
惼	nnsnzhpszhss
愁	phspnnppnnznn
愈	pnhszhhssnznn
愉	nnspnhszhhss
愊	nnshszhszhsh
愋	nnspnnphhpzn
愎	nnsphszhhpzn
意	nhnphszhhnznn
愐	nnshpszsshhh
愑	nnsznszhhszp
愒	nnsszhhpzpnz
愔	nnsnhnphszhh
愕	nnsszhszhhhz
愖	nnshsshhhpnz
愗	znzspphpnnznn
愚	szhhszshnnzn
愜	nnshhpnpnpnz
愝	nnshszhhzphz
感	hphszhzpnnznn
愠	nnsszhhszssh
愡	nnspzppnnznn
愣	nnsszsshnhzp
愤	nnshshssszpn
愧	nnspszhhpzzn
愬	nphzsppzhhnznn
愰	nnsszhhsnphpz
愽	nnshszhhsnhsn
愿	hppszhhspnnznn
慄	nnshszsshhspn
慆	nnspnnppshzhh
慈	nphzznzznnznn
慊	nnsnphzhhsspn
慌	nnshssnhzpsz
慎	nnshsszhhhhpn
慑	nnshsshhhznzn
慕	hssszhhhpnsnnn
慘	nnsznznznpnppp
慛	nnsszspsnhhhsh
慠	nnshhshzpphpn
慢	nnsszhhszsshzn
慣	nnszzshszhhhpn
慧	hhhshhhszhhnznn
慨	nnszhhznhzpz
慫	ppspnpnshpnnznn
慰	zhphhspnhsnnznn
慴	nnsznhznhpszhh
慵	nnsnhpzhhszhhs
慷	nnsnhpzhhsnhpn
慼	hpshhspnzpnnznn
慽	nnshpshhspnzpn
慾	pnpnszhpzpnnznn
憆	nnssnpnzszhhsh
憎	nnsnpszsnphszhh
憙	hshszhnphszhnznn
憜	nnszshphshszhh
憝	nhszhzshphpnnznn
憟	nnshszsshnphspn
憤	nnshshssszhhhpn
憧	nnsnhnphszhhshh
憨	zhsshhhphpnnznn
憩	phsszhpszhhhnznn
憰	nnsznzspszpnszh
憾	nnshphszhzpnnznn
懂	nnshssphszhhshh
懆	nnsszhszhszhhspn
懇	pnnpzppzhhzpnnznn
懈	nnspzpzhhszpphhs
懑	nnhhsshszpnpnnznn
懒	nnshszhspnpzszpn
懞	nnshssnzhhpzpppn
戈	hzpn
戉	hzzpn
戊	hpzpn
戋	hhzpn
戌	hphzpn
戍	hpnzpn
戎	hhpzpn
戏	znhzpn
成	hpzzpn
我	phshzpn
戒	hhpszpn
戕	zshphzpn
或	hszhhzpn
戗	pnzzhzpn
战	shszhhzpn
戚	hpshhspnzpn
戛	hpszhhhhzpn
戞	hpszhhnzhzpn
戡	hsshhhpnzhzpn
戢	szhhsshhhzpn
戳	znhznhpsnhhhshhzpn
戴	hshszhshhsshpnzpn
户	nzhp
戹	nzhpz
戻	nzhphpn
戾	nzhphpnn
房	nzhpnhzp
所	ppzhpphs
扁	nzhpszhss
扇	nzhpznhznh
扈	nzhpszhzshz
扉	nzhpshhhshhh
手	phhs
才	hsp
扎	hshz
扑	hshsn
扒	hshpn
打	hshhs
扔	hshzp
托	hshphz
扙	hshhpn
扚	hshpzn
扛	hshhsh
扣	hshszh
扦	hshphs
执	hshpzn
扨	hshzpn
扩	hshnhp
扪	hshnsz
扫	hshzhh
扬	hshzpp
扭	hshzshh
扮	hshpnzp
扯	hshshsh
扰	hshhpzn
扱	hshpzn
扲	hshpnnz
扳	hshppzn
扴	hshpnps
扶	hshhhpn
批	hshhzpz
扼	hshhpzz
扽	hshhzsz
找	hshhzpn
承	zshhhzpn
抄	hshspnp
抉	hshzhpn
把	hshzshz
抌	hshnzpz
抎	hshhhzn
抐	hshszpn
抑	hshpzzs
抒	hshznzs
抓	hshppsn
投	hshpzzn
抖	hshnnhs
抗	hshnhpz
折	hshpphs
抚	hshhhpz
抛	hshpzzp
抝	hshzznz
抟	hshhhzn
抠	hshhpnz
抡	hshpnpz
抢	hshpnzz
护	hshnzhp
报	hshzszn
披	hshzpszn
抬	hshznszh
抱	hshpzzhz
抵	hshpzhzn
抹	hshhhspn
抻	hshszhhs
押	hshszhhs
抽	hshszhsh
拂	hshzhzps
拄	hshnhhsh
担	hshszhhh
拆	hshpphsn
拇	hshzznhn
拈	hshshszh
拉	hshnhnph
拊	hshpshsn
拋	hshhpzzp
拌	hshnphhs
拍	hshpszhh
拎	hshpnnzn
拏	zphznphhs
拐	hshszhzp
拒	hshhzhz
拓	hshhpszh
拔	hshhpznn
拖	hshphzsz
拗	hshzznzp
拘	hshpzszh
拙	hshzsszs
拚	hshznhps
招	hshzpszh
拜	phhphhhhs
拟	hshznpn
拢	hshhpzpn
拣	hshhzzpn
拥	hshpzhhs
拦	hshnphhh
拧	hshnnzhs
拨	hshzpznn
择	hshznhhs
拫	hshzhhzpn
括	hshphsszh
拭	hshhhshzn
拯	hshzszpnh
拰	hshpsphsh
拱	hshhsshpn
拳	nphhpnphhs
拴	hshpnhhsh
拷	hshhshphz
拼	hshnphhps
拽	hshszhhzp
拾	hshpnhszh
拿	pnhszhphhs
持	hshhshhsn
挂	hshhshhsh
指	hshpzszhh
挈	hhhszpphhs
按	hshnnzzph
挍	hshnhpnpn
挎	hshhpnhhz
挐	zphszhphhs
挑	hshpnhzpn
挖	hshnnzpnz
挙	nnphpnphhs
挚	hshpznphhs
挛	nhsspnphhs
挟	hshhnphpn
挠	hshhzphpz
挡	hshsnpzhh
挣	hshpzzhhs
挤	hshnhpnps
挥	hshnzhzhs
挨	hshznphhpn
挪	hshzhhpzs
挫	hshpnpnhsh
振	hshhphhzpn
挲	nnhspnpphhs
挴	hshphzznhn
挶	hshzhpzszh
挺	hshphshzn
挽	hshpzszhpz
捁	hshphshszh
捂	hshhszhszh
捅	hshznszhhs
捆	hshszhspnh
捉	hshszhshpn
捋	hshpnnphsn
捌	hshszhzpss
捍	hshszhhhhs
捎	hshsnpszhh
捏	hshszhhhsh
捐	hshszhszhh
捕	hshhszhhsn
捜	hshszhhszn
捞	hshhssnzzp
损	hshszhszpn
捠	hshpshshpn
捡	hshpnhnnph
换	hshpzszhpn
捣	hshpznzsz
捧	hshhhhpnhhs
据	hshzhphsszh
捱	hshhphshhsh
捶	hshphshsshh
捷	hshhzhhshpn
捺	hshhpnhhspn
捻	hshpnnznznn
掀	hshpphspzpn
掂	hshnhpshszh
掇	hshznznznzn
掉	hshshszhhhs
掌	snpnzszhphhs
掎	hshhpnhszhs
掏	hshpzphhszs
掐	hshpzpshzhh
排	hshshhhshhh
掖	hshnhpspznn
掛	hshhshhshsn
掟	hshnnzhshpn
探	hshnzpnhspn
掣	phhszsssphhs
掦	hshszhhpzpp
控	hshnnzpnhsh
推	hshpsnhhhsh
掩	hshhpnszhhz
措	hshhsshszhh
掫	hshhsshhhzn
掬	hshpznphspn
掭	hshhhpnsnnn
掮	hshnzhpszhh
掰	phhppnzpphhs
掲	hshszhhpzpz
掳	hshshzphzzp
掴	hshszhhshnh
掶	hshnhpzhhpn
掷	hshnphhpnzs
掸	hshnpszhhhs
掹	hshzshszssh
掺	hshznhpnppp
掻	hshznszhshn
掼	hshzzshszpn
掿	hshhsshpszh
揀	hshhsznphspn
揄	hshpnhszhhss
揅	hpszhhhpsphh
揉	hshznzsphspn
揊	hshhszhszhsh
揋	hshszhshhzpn
揌	hshszhshnznn
揍	hshhhhpnhhpn
揎	hshnnzhszhhh
描	hshhssszhsh
提	hshszhhhshpn
揑	hshpshzhhhsh
插	hshphspshzhh
揔	hshpzppnnznn
揕	hshhsshhhpnz
揖	hshszhhsshhh
揗	hshpphsszhhh
揘	hshpszhhhhsh
揙	hshnzhpszhss
揝	hshpznsnszhh
揟	hshzshpnszhh
揠	hshhszhhzphz
握	hshzhphznhsh
揢	hshnnzpznszh
揣	hshszshpszss
揤	hshzhhznzs
揥	hshnhnpnzszs
揦	hshhszhspnss
揧	hszhspnssphhs
揨	hshnhszhnzhs
揩	hshhzpzpszhh
揪	hshphspnnppn
揫	phspnnppnphhs
揬	hshnnzpnhpnn
揭	hshszhhpzpnz
揮	hshnzhszhhhs
揯	hshnnshsznnh
揰	hshphszhhshh
揱	snpszhhssphhs
揲	hshhsshzhspn
揳	hshhhhszphpn
援	hshpnnphhpzn
揵	hshzhhhhszn
揶	hshhsshhhzs
揷	hshphspshzhh
揸	hshhspnszhhh
揹	hshshhpzszhh
揺	hshpnnphhszs
揻	hshhphzphzpn
揼	hshhpszhszpn
揽	hshssphnszpz
揾	hshszhhszssh
揿	hshphhhzpzpn
搀	hshpzszhpznn
搁	hshnszpznszh
搂	hshnphspnzph
搃	hshnpszhnznn
搄	hshnnshszhhh
搅	hshnnpnzszpz
搆	hshhhsshszshh
搇	hshpnnznhpzpn
搈	hshnnzpnpnszh
搉	hshnzpsnhhhsh
搌	hshzhphsshzpn
損	hshszhszhhhpn
搏	hshhszhhsnhsn
搐	hshnhzznszhsh
搑	hshhsshsshhs
搒	hshnhnpnznhzp
搓	hshnphhhphsh
搔	hshznnszhshn
搕	hshhshznszssh
搙	hshhphhzpnhsn
搛	hshnphzhhsspn
搜	hshpshzhhszn
搝	hshpszhhhhpnn
搞	hshnhszhszszh
搠	hshnphzsppzhh
搡	hshznznznhspn
搤	hshnphpnszssh
搥	hshpszhzhnzn
搦	hshzhznhzhznh
搧	hshnzhpznhznh
搨	hshszhhznhznh
搩	hshpznhzshspn
搪	hshnhpzhhsszh
搫	ppznhnpzznphhs
搬	hshppznhnpzzn
搭	hshhsspnhszh
搯	hshpnnppshzhh
搰	hshszznzszhh
搳	hshnnzhhhsszh
搴	nnzhhsshpnphhs
搷	hshhsszhhhhpn
搸	hshhhhpnphspn
搹	hshhszhsznphs
携	hshpsnhhhshzp
搼	hshnphhpnphhs
搽	hshhsspnhspn
搾	hshnnzpnphshh
摁	hshszhpnhnznn
摃	hshhshszhhhpn
摄	hshhsshhhznzn
摅	hshshzphznznn
摆	hshszsshhshzn
摇	hshpnnpphhszs
摈	hshnnzpshshpn
摊	hshznpsnhhhsh
摍	hshnnzpshphzhh
摎	hshznhznhpnppp
摏	hshhhhpnpshzhh
摒	hshzhpnphhps
摓	hshpznhhhsnzn
摔	hshnhzznnhpnhs
摕	hshhpsshznzszs
摖	hshpznnznhhspn
摗	hshhszhspnpzpn
摘	hshnhnpszhsszh
摚	hshsnpnzszhhsh
摛	hshnhpnzsszzn
摜	hshzzshszhhhpn
摝	hshnhpzsshhzpz
摞	hshszhshzznspn
摟	hshszhhszhszph
摠	hshpszpznhnznn
摡	hshzhhznhzpz
摢	hshshzphzpnphs
摣	hshshzphzszhhh
摤	hshhpnpnpnpnpn
摥	hshphszhhhpzpp
摦	hshhpnhhzppznn
摧	hshszspsnhhhsh
摨	hshzhpsnhpnphhs
摩	nhphspnhspnphhs
摪	hshzshppznnhsn
摫	hshhhpnszhhhpz
摬	hshnhnphszhhpz
摭	hshnhphsshnnnn
摮	hhshzpphpnphhs
摯	hshnphhspznphhs
摰	hshpnhshpznphhs
摱	hshszhhszsshzn
摵	hshhpshhspnzpn
摸	hshhssszhhhpn
摹	hssszhhhpnphhs
摺	hshznhznhpszhh
摻	hshznznznpnppp
摽	hshhszsshhhspn
摾	hshzhzszhszhshn
撀	hshzshppzznphhs
撂	hshszhshpznszh
撄	hshszpnszpnzph
撅	hshhpnphzsppzpn
撆	npszspnphpnphhs
撇	hshnpszspnphpn
撉	nhszhzshphpnphhs
撌	hshszhshszhhhpn
撍	hshhzpzhzpzszhh
撑	hshsnpnzszhphhs
撒	hshhsshszhhphpn
撔	hshszhhnhszhspn
撕	hshhsshhhpnpphs
撖	hshzhsshhhphpn
撗	hshhsshszhshpn
撙	hshnphszpzhhhsn
撚	hshpznnhpnnnnnn
撛	hshnphspnpznhzs
撜	hshznppnhszhnph
撝	hshpnnppzzznnnn
撞	hshnhnphszhhshh
撠	hshhsszhhhshzpn
撢	hshhszsshszhhhs
撤	hshnhznszhhphpn
撦	hshhpnhshpszhh
撩	hshhpnnpszhhspn
撬	hshphhzphhzphhz
播	hshpnphspnszhsh
撮	hshszhhhsshhhzn
撯	hshnphhhpszhhh
撰	hshzhzzhzhsshpn
撱	hshzshphshszhh
撲	hshssnphnphhhpn
撳	hshpnhhsnphpzpn
撴	hshnhszhzshphpn
撵	hshhhpnhhpnhzhs
撷	hshhshszhhpszpn
撸	hshpzszhshhszhh
撺	hshnnzpnszhszhs
撼	hshhphszhzpnnznn
撽	hshpszhhnhzpphpn
擀	hshhsszhhhspnhhs
擁	hshnhzzppsnhhhsh
擂	hshhnzsnnnnszhsh
擅	hshnhszszhhszhhh
擆	hshhsshshpszhh
擉	hshszsshpzszhshn
擋	hshsnpnzszhszhsh
操	hshszhszhszhhspn
擎	hsspzszhphpnphhs
擏	hshhsspzszhphpn
擑	hshszhhsshhhzpn
擒	hshpnnhpnzsszzn
擔	hshpzhppnnhhhszh
擖	hshhssszhhpzpnz
擗	hshzhpszhnhnphhs
擘	zhpszhnhnphhsphhs
擙	hshpszpnphspnhpn
擞	hshnphspnzphphpn
擢	hshznhznhpsnhhhsh
擤	hshpszhhhszhshhps
擥	hszhszphnszsshphhs
擦	hshnnzpznnznhhspn
擧	pshhhzszhhhpnphhs
擩	hshhnzsnnnnhpszss
擬	hshpzphhpnznzshpn
擮	hshhshpsnhhhshzpn
擲	hshnphszpzhhhpnzs
擵	hshnhphspnhspnphhs
擶	hshphnphnnphszhhss
擷	hshhshszhhpszhhhpn
擹	hshhsshszhhhpnpzpn
攀	hspnpnpnhspnhpnphhs
攅	hshhhpnhhpnszhhhpn
攉	hshhnzsnnnnpsnhhhsh
攋	hshhszhspnpzszhhhpn
攍	hshnhzszhpzhhzphpzn
攒	hshphshpzphshpzszpn
攕	hshpnpnhshhhshhhhzpn
攖	hshszhhhpnszhhhpnzph
攘	hshnhszhszhhhsshpzpn
攝	hshhsshhhhsshhhhsshhh
攞	hshszsshzznnnnpsnhhhsh
攠	hshnhphspnhspnshhhshhh
攫	hshszhhhszhhhpsnhhhshzn
攮	hshhszhsnzszhszhhhsshpzpn
支	hszn
攰	hsznzp
攱	nhnphhszn
攲	hpnhszhshszn
收	zsphpn
攷	hzphpn
攸	pssphpn
改	zhzphpn
攺	zhzphpn
攻	hshphpn
攼	hhsphpn
攽	pnzpphpn
放	nhzpphpn
政	hshshphpn
敀	pszhhphpn
敁	shszhshzn
敄	znzspphpn
故	hsszhphpn
敇	hszspnphpn
效	nhpnpnphpn
敉	nphspnphpn
敊	shhspnshzn
敌	phsszhphpn
敍	pnhhspnshzn
敎	pnhpzshphpn
敏	phzznhnphpn
救	hsnhpnnphpn
敕	hszhspnphpn
敖	hhshzpphpn
敗	szhhhpnphpn
敘	pnhhspnphpn
教	hshpzshphpn
敛	pnhnnphphpn
敜	pnnznznnphpn
敝	npszspnphpn
敞	snpszszhphpn
敢	zhsshhhphpn
散	hsshszhhphpn
敤	szhhhspnshzn
敦	nhszhzshphpn
敫	pszhhnhzpphpn
敬	hsspzszhphpn
数	nphspnzphphpn
敱	szshszhnphshzn
敲	nhszhszszhshzn
敳	szshszhnphphpn
整	hszhspnphpnhshsh
敷	hszhhsnnhzpphpn
敼	hshszhnphszhshzn
斃	npszspnphpnhpznpz
文	nhpn
斈	nhpnzsh
斋	nhpnhpszss
斌	nhpnhhshshzn
斏	nhpnnzhhzpn
斐	shhhshhhnhpn
斑	hhshnhpnhhsh
斓	nhpnnszhsznphspn
斗	nnhs
料	nphspnnnhs
斛	pzpzhhsnnhs
斜	pnhhspnnnhs
斞	pshzhhpnnnhs
斟	hsshhhpnznnhs
斠	hhsshszshhnnhs
斡	hsszhhhspnnnhs
斤	pphs
斥	pphsn
斦	pphspphs
斧	pnpnpphs
斨	zshppphs
斩	hzshpphs
斪	pzszhpphs
斫	hpszhpphs
断	nphspnzpphs
斮	hsshszhhpphs
斯	hsshhhpnpphs
新	nhnphhspnpphs
斳	hsshszhhhshpphs
斴	nphspnpznhzspphs
方	nhzp
斺	nhzppnps
斻	nhzpphpz
於	nhzppnnn
施	nhzpphzsz
斾	nhzpphszs
斿	nhzpphzsh
旀	nhzpznspn
旁	nhnpnznhzp
旂	nhzpphpphs
旃	nhzpphpznh
旄	nhzpphphhz
旅	nhzpphpzpn
旆	nhzpphhszs
旇	nhzpphzpszn
旈	nhzpnhznpsz
旊	nhzpphhzzn
旋	nhzpphzshpn
旌	nhzpphphhsh
旍	nhzpphpnnzn
旎	nhzpphzhppz
族	nhzpphphhpn
旑	nhzphpnhszhs
旔	nhzpzhhhhszn
旖	nhzpphhpnhszhs
旗	nhzpphhsshhhpn
无	hhpz
既	zhhznhzpz
日	szhh
旦	szhhh
旧	sszhh
旨	pzszhh
早	szhhhs
旪	szhhhs
旫	szhhzp
旬	pzszhh
旭	pzszhh
旮	pzszhh
旯	szhhpz
旰	szhhhhs
旱	szhhhhs
旲	szhhhpn
旳	szhhpzn
旴	szhhhhs
旵	szhhszs
时	szhhhsn
旷	szhhnhp
旸	szhhzpp
旺	szhhhhsh
旻	szhhnhpn
旼	szhhnhpn
旽	szhhhzsz
旿	szhhphhs
昀	szhhpznh
昁	szhhhszs
昂	szhhpzzs
昃	szhhhppn
昄	szhhppzn
昅	szhhpzn
昆	szhhhzpz
昇	szhhphps
昈	szhhnzhp
昉	szhhnhzp
昊	szhhhhpn
昋	hhpnszhh
昌	szhhszhh
明	szhhpzhh
昏	pzhzszhh
昐	szhhpnzp
昑	szhhpnnz
昒	szhhpzpp
易	szhhpzpp
昔	hsshszhh
昕	szhhpphs
昖	szhhpnzn
昗	szhhnhpn
昘	szhhnhzp
昙	szhhhhzn
昛	szhhhzhz
昜	szhhhpzpp
昝	pznsnszhh
昞	szhhhszpn
星	szhhphhsh
映	szhhszhpn
昡	szhhnhzzn
昢	szhhzsszs
昣	szhhpnppp
昤	szhhpnnzn
春	hhhpnszhh
昦	szhhhpnps
昧	szhhhhspn
昨	szhhphshh
昩	szhhhhspn
昪	szhhznhps
昫	szhhpzszh
昬	zhzhzszhh
昭	szhhzpszh
是	szhhhshpn
昰	szhhhshsh
昱	szhhnhnph
昲	szhhzhzps
昳	szhhphhpn
昴	szhhpzpzs
昵	szhhzhppz
昶	nzzpnszhh
昷	szhhszssh
昸	szhhpznnn
昹	szhhnzzpn
昻	szhhhshzs
昼	zhpnszhhh
昽	szhhhpzpn
显	szhhssnph
昿	szhhnhpzn
晀	szhhpnhzpn
晁	szhhpnhzpn
時	szhhhshhsn
晃	szhhsnphpz
晄	szhhsnphpz
晅	szhhhszhhh
晆	szhhhshhsh
晈	szhhnhpnpn
晉	hznznhszhh
晊	szhhhznhsh
晋	hssnphszhh
晌	szhhpszszh
晍	szhhszhszh
晎	szhhhsshpn
晏	szhhnnzzph
晐	szhhnhzppn
晑	szhhpszszh
晒	szhhhszpzh
晓	szhhhzphpz
晔	szhhpspzhs
晕	szhhnzhzhs
晖	szhhnzhzhs
晗	szhhpnnzszh
晘	szhhszhhhhs
晙	szhhznpnpzn
晚	szhhpzszhpz
晛	szhhszhhhpz
晞	szhhpnhpszs
晟	szhhhpzzpn
晠	szhhhpzzpn
晡	szhhhszhhsn
晢	hshpphsszhh
晣	szhhhshpphs
晤	szhhhszhszh
晥	szhhnnzhhpz
晦	szhhphzznhn
晧	szhhphshszh
晨	szhhhphhzpn
晩	szhhpzszshpz
晪	szhhszhsshpn
晫	szhhshszhhhs
晬	szhhnhpnpnhs
晭	szhhpzhshszh
普	nphssnphszhh
景	szhhnhszhspn
晰	szhhhspnpphs
晱	szhhnppnnppn
晲	szhhpshzhhpz
晳	hspnpphsszhh
晴	szhhhhshszhh
晶	szhhszhhszhh
晷	szhhpznsnszh
晹	szhhszhhpzpp
智	phhpnszhszhh
晻	szhhhpnszhhz
晼	szhhnnzpznzz
晽	szhhhspnhspn
晾	szhhnhszhspn
晿	szhhszhhszhh
暀	szhhppsnhhsh
暁	szhhhshsshpz
暂	hzshpphsszhh
暃	szhhshhhshhh
暄	szhhnnzhszhhh
暅	szhhnnshszhhh
暆	szhhnhzpphzsz
暇	szhhzhshhzhzn
暈	szhhnzhszhhhs
暉	szhhnzhszhhhs
暌	szhhznppnhhpn
暍	szhhszhhpzpnz
暎	szhhhssszhpn
暏	szhhhshpszhh
暑	szhhhshpszhh
暒	szhhszhhphhsh
暔	szhhhssznphhs
暕	szhhhsznphspn
暖	szhhpnnphhpzn
暗	szhhnhnphszhh
暙	szhhhhhpnszhh
暚	szhhpnnpphhszs
暛	szhhnphhhphsh
暝	szhhnzszhhnhpn
暞	szhhpszhhhhspn
暟	szhhszshszhnph
暠	szhhnhszhszszh
暡	szhhpnznznhznh
暢	szhhsszhhhpzpp
暤	szhhpszhhhpnhs
暥	szhhszhhnnzzph
暦	hphspnhspnszhh
暧	szhhpnnpnzhpzn
暨	zhhznhzpzszhhh
暩	szhhpznnznhhspn
暪	szhhhsshszspnpn
暮	hssszhhhpnszhh
暯	szhhhssszhhhpn
暱	szhhhhsshpszhz
暲	szhhnhnphszhhhs
暳	szhhhhhshhhszhh
暴	szhhhsshpnsnhpn
暶	szhhnhzpphzshpn
暸	szhhhpnnpszhhspn
暹	szhhpsnhhhshnzn
暻	szhhszhhnhszhspn
暼	npszspnphpnszhh
暽	szhhnphspnpznhzs
暾	szhhnhszhzshphpn
暿	szhhhshszhnphszh
曀	szhhhshnzhszhpnh
曁	pszhhhzhzpzszhhh
曂	szhhhsshszhshpn
曃	szhhzhhsnhpnnzn
曄	szhhhsshhshshhs
曅	szhhhsshhsshhs
曆	hpphspnphspnszhh
曈	szhhnhnphszhhshh
曊	szhhzhzpsszhhhpn
曋	szhhhszsshszhhhs
曍	szhhpszhhhnhpnhs
曎	szhhszsshhshnphhs
曒	szhhpszhhnhzpphpn
曔	szhhhsspzszhphpn
曕	szhhpzhppnnhhhszh
曘	szhhhnzsnnnnhpszss
曙	szhhszsshhshpszhh
曚	szhhhssnzhhpzpppn
曛	szhhphsznphshhnnnn
曜	szhhznhznhpsnhhhsh
曝	szhhszhhhsshpnsnhpn
曠	szhhnhphsshszhshpn
曢	szhhnnzhpnnpszhhspn
曤	szhhhnzsnnnnpsnhhhsh
曦	szhhnphhshphspnhzzpn
曪	szhhszsshzznnnnpsnhhhsh
曬	szhhhsznhsznnhpzsshhzpz
曰	szhh
曲	szhssh
曳	szhhzp
更	hszhhpn
曵	szhhzpn
曹	hszhsshszhh
曼	szhhszsshzn
曾	npszsnphszhh
替	hhpnhhpnszhh
最	szhhhsshhhzn
朅	hshznszhhpzpnz
月	pzhh
有	hpszhh
朊	pzhhhhpz
朋	pzhhpzhh
朌	pzhhpnzp
服	pzhhzszn
朎	pzhhpnnzn
朏	pzhhzsszs
朐	pzhhpzszh
朑	pzhhhsshz
朓	pzhhpnhzpn
朔	nphzsppzhh
朕	pzhhnphhpn
朖	pzhhnzhhzpn
朗	nzhhznpzhh
朘	pzhhznpnpzn
望	nhzpzhhhhsh
朜	pzhhnhszhzsh
朝	hsszhhhspzhh
期	hsshhhpnpzhh
朠	pzhhhssszhpn
朣	pzhhnhnphszhhshh
朦	pzhhhssnzhhpzpppn
朧	pzhhnhnphszhhshzhzhhh
木	hspn
未	hhspn
末	hhspn
本	hspnh
札	hspnz
术	hspnn
朱	phhspn
朲	hspnpn
朳	hspnpn
朴	hspnsn
朵	pzhspn
朶	zphspn
朷	hspnzp
朸	hspnzp
朹	hspnpz
机	hspnpz
朻	hspnzs
朼	hspnpz
朽	hspnhz
朾	hspnhs
朿	hszspn
杀	pnhspn
杁	hspnpn
杂	pzhspn
权	hspnzn
杄	hspnphs
杅	hspnhhs
杆	hspnhhs
杇	hspnhhz
杈	hspnznn
杉	hspnppp
杊	hspnpss
杋	hspnpzn
杌	hspnhpz
杍	hspnzsh
李	hspnzsh
杏	hspnszh
材	hspnhsp
村	hspnhsn
杒	hspnzpn
杓	hspnpzn
杔	hspnphz
杕	hspnhpn
杖	hspnhpn
杗	nhzhspn
杘	zhphspn
杙	hspnhzn
杚	hspnphz
杛	hspnzhz
杜	hspnhsh
杝	hspnzsz
杞	hspnzhz
束	hszhspn
杠	hspnhsh
条	pznhspn
杣	hspnszs
杤	hspnhzp
来	hnphspn
杦	hspnpzn
杧	hspnnhz
杨	hspnzpp
杩	hspnzzh
杪	hspnspnp
杫	hspnshsh
杬	hspnhhpz
杭	hspnnhpz
杮	hspnhszs
杯	hspnhpsn
杰	hspnnnnn
東	hszhhspn
杲	szhhhspn
杳	hspnszhh
杴	hspnpzpn
杵	hspnphhs
杶	hspnhzsz
杷	hspnzshz
杸	hspnpzzn
杹	hspnpspz
杺	hspnnznn
杻	hspnzshh
杼	hspnznzs
杽	hspnphhs
松	hspnpnzn
板	hspnppzn
枀	pnznhspn
极	hspnpzn
枂	hspnpzhh
枃	hspnpznh
构	hspnpzzn
枅	hspnhhps
枆	hspnphhz
枇	hspnhzpz
枈	hzpzhspn
枉	hspnhhsh
枊	hspnpzzs
枋	hspnnhzp
枌	hspnpnzp
枍	hspnpnhz
枎	hspnhhpn
枏	hspnszhh
析	hspnpphs
枑	hspnhzzh
枒	hspnhzsp
枓	hspnnnhs
枔	hspnpnnz
枕	hspnnzpz
枖	hspnphpn
林	hspnhspn
枘	hspnszpn
枙	hspnhpzz
枚	hspnphpn
枛	hspnppsn
果	szhhhspn
枝	hspnhszn
枞	hspnpnpn
枟	hspnhhzn
枠	hspnpzhs
枡	hspnphps
枢	hspnhpnz
枣	hszspnnn
枤	hspnhpnn
枥	hspnhpzp
枦	hspnnzhp
枧	hspnszpz
枨	hspnphzn
枪	hspnpnzz
枫	hspnpzpn
枬	hspnpznh
枭	pznzhspn
枮	hspnshszh
枯	hspnhsszh
枰	hspnhnphs
枱	hspnznszh
枲	znszhhspn
枳	hspnszhpn
枵	hspnszhhz
架	zpszhhspn
枷	hspnzpszh
枸	hspnpzszh
枹	hspnpzzhz
枺	hspnhhspn
枻	hspnhsshz
枿	hspnhshps
柀	hspnzpszn
柁	hspnnnzpz
柂	hspnphzsz
柃	hspnpnnzn
柄	hspnhszpn
柅	hspnzhppz
柆	hspnnhnph
柇	hspnphspn
柈	hspnnphhs
柉	hspnpnzn
柊	hspnpznnn
柋	pshznhspn
柌	hspnzhszh
柍	hspnszhpn
柎	hspnpshsn
柏	hspnpszhh
某	hsshhhspn
柑	hspnhsshh
柒	nnhhzhspn
染	nnhpzhspn
柔	znzsphspn
柕	hspnznzsp
柖	hspnzpszh
柘	hspnhpszh
柙	hspnszhhs
柚	hspnszhsh
柛	hspnszhhs
柜	hspnhzhz
柝	hspnpphsn
柞	hspnphshh
柟	hspnszshh
柠	hspnnnzhs
柢	hspnpzhzn
柣	hspnphhpn
柤	hspnszhhh
查	hspnszhhh
柦	hspnszhhh
柧	hspnppznn
柨	hspnhpszs
柩	hspnhpznz
柪	hspnzznzp
柫	hspnzhzps
柬	hsznphspn
柭	hspnhpznn
柮	hspnzsszs
柯	hspnhszhs
柰	hspnhhspn
柱	hspnnhhsh
柲	hspnnznpn
柳	hspnpzpzs
柴	shshpzhspn
柵	hspnszssh
柶	hspnszpzh
柷	hspnszhpz
柸	hspnhpsnh
柹	hspnpzsp
柺	hspnszhzp
査	hspnszhhh
柼	hspnnnzpn
柽	hspnznhsh
柾	hspnhshsh
柿	hspnnhszs
栀	hspnpphzz
栁	hspnpznzs
栂	hspnzznhn
栃	hspnpphzp
栄	nnpnzhspn
栅	hspnpzpzh
栆	hszhspnnn
标	hspnhhspn
栈	hspnhhzpn
栉	hspnhsszs
栊	hspnhpzpn
栋	hspnhzspn
栌	hspnshzhp
栍	hspnphhsh
栎	hspnpzspn
栏	hspnnphhh
栐	hspnnzzpn
树	hspnznhsn
栒	hspnpzszhh
栓	hspnpnhhsh
栔	hhhszphspn
栕	hspnhszhsz
栖	hspnhszpzh
栗	hszsshhspn
栘	hspnpznpzn
栙	hspnpznhzs
栚	hspnnphhpn
栛	hspnzpzpzp
栜	hspnhszspn
栝	hspnphsszh
栟	hspnnphhps
栠	psphshhspn
校	hspnnhpnpn
栢	hspnhpszhh
栣	hspnpsphsh
栤	hspnnhszpn
栥	nhpzpnhspn
栦	hspnnpnsns
栧	hspnszhhzp
栩	hspnznhznh
株	hspnphhspn
栭	hspnhpszss
栮	hspnhsshhh
栯	hspnhpszhh
栰	hspnpshzpn
栱	hspnhsshpn
栲	hspnhshphz
栳	hspnhshppz
栵	hspnhpznss
样	hspnnphhhs
核	hspnnhzppn
根	hspnzhhzpn
栺	hspnpzszhh
栻	hspnhhshzn
格	hspnpznszh
栽	hshhspnzpn
栾	nhsspnhspn
栿	hspnpshpnn
桀	pznhzshspn
桁	hspnppshhs
桂	hspnhshhsh
桃	hspnpnhzpn
桄	hspnsnphpz
桅	hspnpzhpzz
框	hspnhhhshz
桇	zphszhhspn
案	nnzzphhspn
桉	hspnnnzzph
桊	nphhpnhspn
桋	hspnhzhzpn
桌	shszhhhspn
桍	hspnhpnhhz
桎	hspnhznhsh
桏	hspnhshzs
桐	hspnszhszh
桑	znznznhspn
桒	hshsshspn
桓	hspnhszhhh
桔	hspnhshszh
桕	hspnpshzhh
桖	hspnpszssh
桗	hspnzphspn
桘	hspnpszhzh
桙	hspnznphhs
桝	hspnpznhzs
桞	hspnpznzs
桟	hspnhhhzpn
桠	hspnhssnph
桡	hspnhzphpz
桢	hspnshszpn
档	hspnsnpzhh
桤	hspnszszhz
桥	hspnphpnps
桦	hspnpspzhs
桧	hspnpnhhzn
桨	nhspznhspn
桩	hspnnhphsh
桪	hspnzhhhsn
桫	hspnnnhspnp
桬	nnhspnphspn
桭	hspnhphhzpn
桮	hspnhpsnszh
桯	hspnszhhhsh
桲	hspnhsnzzsh
桴	hspnpnnpzsh
桵	hspnpnnpzph
桶	hspnznszhhs
桷	hspnpzpzhhs
桸	hspnpnhpszs
桹	hspnnzhhzpn
桻	hspnpznhhhs
桼	hspnpnsnhpn
桽	hspnpnpnhsh
桾	hspnzhhpszh
桿	hspnszhhhhs
梀	hspnhszhspn
梁	nnhzpnnhspn
梂	hspnhsnhpnn
梃	hspnphshzn
梄	hspnhszpzhh
梅	hspnphzznhn
梆	hspnhhhpzs
梇	hspnhhshhps
梈	hspnnhszhzs
梊	hshpphshspn
梋	hspnszhszhh
梌	hspnpnhhspn
梍	hspnpszhhhz
梎	hspnpszhhpz
梏	hspnphshszh
梐	hspnhzpzhsh
梑	hspnpzpnppn
梒	hspnpnnzszh
梓	hspnnhnphhs
梔	hspnpphzshz
梕	hspnzpnnznn
梖	hspnszhhhpn
梗	hspnhszhhpn
梙	hspnszhszhs
梚	hspnpzszhpz
梛	hspnzhhpzs
梜	hspnhpnpnpn
梞	hspnzhznznn
梠	hspnszhszh
梡	hspnnnzhhpz
梢	hspnsnpszhh
梣	hspnszspnnz
梦	hspnhspnpzn
梧	hspnhszhszh
梨	phspnsshspn
梩	hspnszhhshh
梪	hspnhszhnph
梫	hspnzhhnzzn
梬	hspnszhshhz
梭	hspnznpnpzn
梮	hspnzhpzszh
梯	hspnnpzhzsp
械	hspnhhpszpn
梱	hspnszhspnh
梲	hspnpnszhpz
梳	hspnnhznpsz
梴	hspnpshzzn
梵	hspnhspnpzn
梶	hspnzhpphhz
梷	shszhznhspn
梸	hspnphspnss
梹	hspnpshshpn
梻	hspnpszhzps
梼	hspnhhhphsn
梽	hspnhshnznn
梾	hspnhnphspn
梿	hspnhzhsnzn
检	hspnpnhnnph
棁	hspnnpszhpz
棂	hspnzhhnppn
棃	phspnpzphspn
棅	hspnphzhhspn
棇	hspnpnznnznn
棈	hspnhhshszhh
棉	hspnpszhhszs
棊	hsshhhpnhspn
棋	hspnhsshhhpn
棌	hspnpnnphspn
棍	hspnszhhhzpz
棎	hspnnzpnhspn
棏	hspnszhhhhsn
棐	shhhshhhhspn
棑	hspnshhhshhh
棒	hspnhhhpnhhs
棓	hspnnhnphszh
棔	hspnpzhzszhh
棕	hspnnnzhhspn
棖	hspnhshhhzpn
棘	hszspnhszspn
棙	hspnnzhphpnn
棚	hspnpzhhpzhh
棛	hspnnhznszhh
棜	hspnnhzppnnn
棝	hspnszhsszhh
棞	hspnszphspnh
棟	hspnhszhhspn
棠	snpnzszhhspn
棡	hspnsznphszs
棢	hspnsznphnhz
棣	hspnzhhsnhpn
棤	hspnhsshszhh
棦	hspnpzzhhs
棪	hspnnppnnppn
棫	hspnhszhhzpn
棬	hspnnphhpnzz
棭	hspnnhpspznn
森	hspnhspnhspn
棯	hspnpnnznznn
棰	hspnphshsshh
棱	hspnhshpnpzn
棲	hspnhzhhszph
棳	hspnznznznzn
棴	hspnpzhhzszn
棵	hspnszhhhspn
棶	hspnhpnpnspn
棷	hspnhsshhhzn
棸	hsshhhznhspn
棹	hspnshszhhhs
棺	hspnnnzszhzh
棻	hsspnzphspn
棼	hspnhspnpnzp
棽	hspnhspnpnnz
棾	hspnhspnnzpz
棿	hspnpshzhhpz
椀	hspnnnzpznzz
椁	hspnnhszhzsh
椂	hspnzhhsnhpn
椄	hspnnhnphzph
椅	hspnhpnhszhs
椆	hspnpzhshszh
椇	hspnszhhhhpn
椈	hspnpznphspn
椊	hspnnhpnpnhs
椋	hspnnhszhspn
椌	hspnnnzpnhsh
植	hspnhsszhhhh
椎	hspnpsnhhhsh
椐	hspnzhphsszh
椑	hspnpszhhphs
椒	hspnshhspnzn
椓	hspnhpzppnpn
椔	hspnzzzszhsh
椖	hspnnzhpnhzp
椗	hspnnnzhshpn
椘	hspnhspnnzn
椙	hspnszhhszhh
椞	hspnpphshspn
椟	hspnhsznnhpn
椠	hzshpphshspn
椡	hspnhznhshss
椢	hspnszhhshnh
椣	hspnszhsshpn
椤	hspnszsshpzn
椥	hspnphhpnszh
椦	hspnnphhpnzp
椧	hspnpnhszhzs
椨	hspnnhppshsn
椩	hspnnhpzhhpn
椪	hspnnphssnph
椫	hspnnpszhhhs
椬	hspnnnzszhhh
椭	hspnzshpszhh
椮	hspnznhpnppp
椯	hspnszshpszss
椰	hspnhsshhhzs
椱	hspnphszhhpzn
椳	hspnszhshhzpn
椴	hspnpshhhpzzn
椶	hspnpnzspnpzn
椷	hspnhphszhzpn
椸	hspnnhzpphzsz
椹	hspnhsshhhpnz
椺	hspnpsszhhspn
椻	hspnhszhhzphz
椼	hspnppsnnhhhs
椽	hspnzzhpzpppn
椾	hspnnphszhhss
椿	hspnhhhpnszhh
楀	hspnpszhszshn
楁	hspnnnzpznszh
楂	hspnhspnszhhh
楃	hspnzhphznhsh
楄	hspnnzhpszhss
楅	hspnhszhszhsh
楆	hspnhszsshzph
楈	hspnzshpnszhh
楉	hspnhsshpszh
楋	hspnhszhspnss
楌	hspnnhnphpppp
楐	hspnszhshpnps
楑	hspnznppnhhpn
楒	hspnszhshnznn
楔	hspnhhhszphpn
楕	hspnhphshszhh
楖	hspnzhhznzs
楗	hspnzhhhhszn
楘	znzspphpnhspn
楚	hspnhspnzshpn
楜	hspnhsszhpzhh
楝	hspnhsznphspn
楞	hspnszsshnhzp
楟	hspnnhszhnzhs
楠	hspnhssznphhs
楡	hspnpnhszhhzz
楢	hspnnphszpzhh
楣	hspnzshpszhhh
楤	hspnpzppnnznn
楥	hspnpnnphhpzn
楦	hspnnnzhszhhh
楧	hspnhssszhpn
楨	hspnshszhhhpn
楩	hspnpshszhhpn
楫	hspnszhhsshhh
楬	hspnszhhpzpnz
楮	hspnhshpszhh
楯	hspnpphsszhhh
楰	hspnpshzhhpn
楱	hspnhhhpnhhpn
楳	hspnhsshhhspn
楴	hspnnhnpnzszs
極	hspnzsszhznh
楷	hspnhzpzpszhh
楸	hspnphspnnppn
楹	hspnzpznszssh
楺	hspnznzsphspn
楻	hspnpszhhhhsh
楼	hspnnphspnzph
楾	hspnpszhhszpn
楿	hspnphspnszhh
榀	hspnszhszhszh
榁	hspnnnzhznhsh
概	hspnzhhznhzpz
榄	hspnssphnszpz
榅	hspnszhhszssh
榆	hspnpnhszhhss
榇	hspnnhnphhspn
榈	hspnnszszhszh
榉	hspnnnphpnhhs
榍	hspnzhpsnpszhh
榎	hspnhpszhhhpzn
榏	hspnnphpnszssh
榐	hspnzhphsshzpn
榑	hspnhszhhsnhsn
榒	hspnzhznhzhznh
榓	hspnnznpnszssh
榔	hspnnzhhznzs
榕	hspnnnzpnpnszh
榖	hshnzhhspnpzzn
榗	hspnhssnphszhh
榘	phhpnhzhzhspn
榙	hspnhsspnhszh
榚	hspnnphhshnnnn
榛	hspnhhhpnphspn
榜	hspnnhnpnznhzp
榝	hspnpnhspnpzzn
榞	hspnhppszhhspn
榟	hspnnnznhnphhs
榠	hspnnzszhhnhpn
榡	hspnhhshzznspn
榢	hspnnnzhpzpppn
榣	hspnpnnpphhszs
榤	hspnpznhzshspn
榥	hspnszhhsnphpz
榦	hsszhhhspnhspn
榧	hspnhshhhshhhz
榨	hspnnnzpnphshh
榩	hspnshzphznhpn
榫	hspnpsnhhhshhs
榬	hspnhshszhpzpn
榭	hspnpszhhhphsn
榰	hspnhshppzszhh
榱	hspnnhszhhpzpn
榲	hspnszpnhszssh
榳	hspnnhpphshzn
榴	hspnpznzpszhsh
榵	hspnhsshsshhh
榶	hspnnhpzhhsszh
榻	hspnszhhznhznh
榼	hspnhshznszssh
榽	hspnpnnpzznhpn
榾	hspnszznzszhh
榿	hspnszshszhnph
槁	hspnnhszhszszh
槃	ppznhnpzznhspn
槄	hspnpnnppshzhh
槅	hspnhszhsznphs
槆	hspnhsspzszhh
槈	hspnhphhzpnhsn
槉	hspnnhpnhphhpn
槊	nphzsppzhhhspn
槌	hspnpszhzhnzn
槎	hspnnphhhphsh
槏	hspnnphzhhsspn
槐	hspnpszhhpzzn
槒	hspnnhzznszhsh
槓	hspnhshszhhhpn
槔	hspnpszhhhpnhs
槕	hspnshszhhhspn
槖	hshnzhpszhhspn
槗	hspnhpszhszszh
槙	hspnhsszhhhhpn
槚	hspnhszsshszpn
槛	hspnssphnszssh
槜	hspnpsnhhhshzp
槞	hspnnhnphszhhz
槟	hspnnnzpshshpn
槠	hspnnzhshpszhh
槡	hspnznznznhspn
槣	hspnnnzhpnhszhs
槤	hspnhszhhhsnzn
槥	hspnhhhshhhszhh
槦	hspnnhpzhhszhhs
槨	hspnnhszhzshzs
槬	hspnhpnhhzppznn
槭	hspnhpshhspnzpn
槮	hspnznznznpnppp
槯	hspnszspsnhhhsh
槰	hspnpznhhhsnzn
槲	hspnpzpzhhsnnhs
槳	zshppznnhsnhspn
槴	hspnnzhpszhzshz
槵	hspnszhszhsnznn
槺	hspnnhpzhhsnhpn
槻	hspnhhpnszhhhpz
槼	hhpnszhhhpzhspn
槽	hspnhszhsshszhh
槾	hspnszhhszsshzn
槿	hspnhsshszhhhsh
樀	hspnnhnpszhsszh
樁	hspnhhhpnpshzhh
樃	hspnnzhhznpzhh
樆	hspnnhpnzsszzn
樈	hspnnhnphszhhpz
樉	hspnhpnpnpnpnpn
樊	hspnpnpnhspnhpn
樋	hspnznszhhsnzn
樎	hspnnnzpshpszhh
樏	hspnszhshzznspn
樐	hspnshszpnnnnnh
樑	hspnnnhzpnnhspn
樔	hspnzzzszhhhspn
樕	hspnhszhspnpzpn
樘	hspnsnpnzszhhsh
標	hspnhszsshhhspn
樚	hspnnhpzsshhzpz
樛	hspnznhznhpnppp
樜	hspnnhphsshnnnn
樟	hspnnhnphszhhhs
模	hspnhssszhhhpn
樦	hspnphnphnnhhsh
樨	hspnzhpsnhpnphhs
横	hspnhsshszhshpn
樫	hspnhszhszznhsh
樬	hspnpszpznhnznn
樭	hspnhsshhhpnhsh
樯	hspnhsnphszszhh
樰	hspnhnzsnnnnzhh
樱	hspnszpnszpnzph
樵	hspnpsnhhhshnnnn
樶	hspnszhhhsshhhzn
樸	hspnssnphnphhhpn
樹	hspnhshszhnphhsn
樺	hspnhsshhsshhs
樻	hspnszhshszhhhpn
樼	hspnzhpzshzshzsh
樽	hspnnphszpzhhhsn
樾	hspnhshshpnhzzpn
樿	hspnszhszhszhhhs
橀	hspnnhznpszszssh
橁	hspnphnphnpzszhh
橂	hspnnphszpzhhhpn
橃	hspnznppnzhzpzzn
橄	hspnzhsshhhphpn
橇	hspnphhzphhzphhz
橉	hspnnphspnpznhzs
橎	hspnpnphspnszhsh
橏	hspnnphhhsnphszh
橑	hspnhpnnpszhhspn
橓	hspnpnnpnzpznhzs
橔	hspnnhszhzshphpn
橕	hspnsnpnzszhhzsp
橖	hspnsnpnzszhhspn
橗	hspnhssszhhpzhh
橘	hspnznzspszpnszh
橙	hspnznppnhszhnph
橛	hspnhpnphzsppzpn
橜	hpnphzsppzpnhspn
橝	hspnhszsshszhhhs
橞	hspnhszhhshnnznn
機	hspnzznzznhpnzpn
橡	hspnpzszhpzpppn
橢	hspnzshphshszhh
橦	hspnnhnphszhhshh
橧	hspnnpszsnphszhh
橪	hspnpznnhpnnnnnn
橫	hspnhsshhszhshpn
橬	hspnhzpzhzpzszhh
橭	hspnhsszhnhnphhs
橲	hspnhshszhnphszh
橵	hspnhsshszhhphpn
橶	hspnhsszhhhshzpn
橹	hspnpzszhshhszhh
橼	hspnzzhzzhpzpppn
橽	hspnhshnphhhsnzn
橾	hspnszhszhszhhspn
橿	hspnhszhshhszhshh
檀	hspnnhszszhhszhhh
檁	hspnnhszszhhphspn
檄	hspnpszhhnhzpphpn
檊	hspnhsszhhhspnhhs
檋	hspnhsshpnhszhhhs
檌	hspnszsshshhhshhh
檍	hspnnhnphszhhnznn
檎	hspnpnnhpnzsszzn
檐	hspnpzhppnnhhhszh
檑	hspnhnzsnnnnszhsh
檒	hspnhspnpzpszhshn
檓	hspnpshzhhhshpzzn
檔	hspnsnpnzszhszhsh
檕	hszhhhszspzznhspn
檖	hspnnphpzpppnnzn
檗	zhpszhnhnphhshspn
檘	hspnzhpszhnhnphhs
檙	hspnszhhhzhpshsz
檚	hspnhspnhspnzshpn
檝	hspnszhhsshhhzpn
檞	hspnpzpzhhszpphhs
檣	hspnhspnpnhszszhh
檦	hspnhszsshhhspnss
檩	hspnnhszszhhhhspn
檫	hspnnnzpznnznhhspn
檬	hspnhssnzhhpzpppn
檰	hspnzznnnnpszhhszs
檱	hspnphnphnhsshhhpn
檺	hspnnhszhnzhpzpppn
檽	hspnhnzsnnnnhpszss
櫂	hspnznhznhpsnhhhsh
櫄	hspnphsznphshhnnnn
櫆	hspnpszhhpzznnnhs
櫓	hspnpzszhshnnnnszhh
櫘	hspnhhhshhhszhhnznn
櫴	hspnhszhspnpzszhhhpn
櫵	hspnhsspsnhhhshnnnn
櫼	hspnpnpnhshhhshhhhzpn
欠	pzpn
次	nhpzpn
欢	znpzpn
欣	pphspzpn
欧	hpnzpzpn
欮	nphzsppzpn
欰	pszsshpzpn
欱	pnhszhpzpn
欲	pnpnszhpzpn
欶	hszhspnpzpn
欺	hsshhhpnpzpn
款	hshhhspnpzpn
欿	pzpshzhhpzpn
歁	hsshhhpnzpzpn
歂	szshpszsspzpn
歃	phspshzhhpzpn
歆	nhnphszhhpzpn
歇	szhhpzpnzpzpn
歉	nphzhhsspnpzpn
歊	nhszhszszhpzpn
歌	hszhshszhspzpn
歏	hsshszhhhshpzpn
歔	shzphzssnphpzpn
歖	hshszhnphszhpzpn
止	shsh
正	hshsh
此	shshpz
步	shshspp
武	hhshshzn
歧	shshhszn
歨	shshshpn
歩	shshspnp
歪	hpsnhshsh
歫	shshhzhz
歭	shshhshhsn
歵	shshhhshszhhhpn
歹	hpzn
歺	shpzn
死	hpznpz
歼	hpznphs
歽	hpznpphs
歾	hpznpzpp
歿	hpznzpzn
殀	hpznphpn
殁	hpznpzzn
殂	hpznszhhh
殃	hpznszhpn
殄	hpznpnppp
殅	hpznphhsh
殆	hpznznszh
殇	hpznphzpp
殈	hpznpszssh
殉	hpznpzszhh
殊	hpznphhspn
残	hpznhhzpn
殌	hpznhzzzhsh
殍	hpznpnnpzsh
殐	hpznhszhspn
殒	hpznszhszpn
殓	hpznpnhnnph
殔	hpznzhhsnhpn
殕	hpznnhnphszh
殖	hpznhsszhhhh
殗	hpznhpnszhhz
殘	hpznhzpnhzpn
殚	hpznnpszhhhs
殛	hpznzsszhznh
殜	hpznhsshzhspn
殝	hpznhhhpnphspn
殞	hpznszhszhhhpn
殟	hpznszhhszssh
殡	hpznnnzpshshpn
殣	hpznhsshszhhhsh
殤	hpznphszhhhpzpp
殩	hpznhpznznnphspn
殭	hpznhszhshhszhshh
殱	hpznhshshhhshhhhzpn
殴	hpnzpzzn
段	pshhhpzzn
殶	nhhshpzzn
殷	ppzhhzpzzn
殽	pnhpszhhpzzn
殾	hshpszhhpzzn
殿	zhphsshpnpzzn
毀	pshzhhhshpzzn
毁	pshzhhhshpzzn
毂	hshnzhzshpzzn
毃	nhszhszszhpzzn
毅	nhnphpzpppnpzzn
毋	zzph
母	zznhn
每	phzznhn
毑	zznhnzsz
毒	hhshzznhn
毓	phzznhnnhznpsz
比	hzpz
毕	hzpzhs
毖	hzpznznpn
毗	szhshhzpz
毙	hzpzhpznpz
毛	phhz
毡	phhzshszh
毦	hsshhhphhz
毫	nhszhnzphhz
毭	hszhnphphhz
毯	phhznppnnppn
毰	phhznhnphszh
毱	phhzpznphspn
毷	szhhszhhhphhz
毹	pnhszhhssphhz
毼	szhhpzpnzphhz
毽	phhzzhhhhszn
氁	phhzhssszhhhpn
氄	znzspszpnszhphhz
氅	snpszszhphpnphhz
氈	nhszszhhszhhhphhz
氊	phhznhszszhhszhhh
氏	pzhz
氐	pzhzn
民	zhzhz
氒	pzhzhs
氓	nhzzhzhz
气	phhz
氕	phhzp
氖	phhzzp
気	phhzpn
氘	phhzps
氙	phhzszs
氚	phhzpss
氛	phhzpnzp
氜	phhzszhh
氝	phhzszpn
氞	phhzhszpn
氟	phhzzhzps
氠	phhzszhhs
氡	phhzpznnn
氢	phhzznhsh
氣	phhznphspn
氤	phhzszhpnh
氥	phhzhszpzh
氦	phhznhzppn
氧	phhznphhhs
氨	phhznnzzph
氩	phhzhssnph
氪	phhzhsszhpz
氫	phhzhzzzhsh
氬	phhzhshzzhsh
氭	phhzhszhhspn
氮	phhznppnnppn
氯	phhzzhhsnhpn
氰	phhzhhshszhh
氱	phhzszhhhpzpp
氲	phhzszhhszssh
氳	phhzszpnhszssh
水	szpn
氶	zszpn
永	nzzpn
氻	nnhzp
氽	pnszpn
氾	nnhzz
氿	nnhpz
汀	nnhhs
汁	nnhhs
求	hsnhpnn
汃	nnhpn
汄	nnhpn
汅	nnhhz
汆	pnszpn
汇	nnhhz
汈	nnhzh
汉	nnhzn
汊	nnhznn
汋	nnhpzn
汌	nnhpss
汍	nnhpzn
汎	nnhpzn
汏	nnhhpn
汐	nnhpzn
汑	nnhphz
汒	nnhnhz
汓	nnhzsh
汔	nnhphz
汕	nnhszs
汖	szsszpn
汗	nnhhhs
汘	nnhphs
汙	nnhhhs
汚	nnhhhz
汛	nnhzhs
汜	nnhzhz
汝	nnhzph
汞	hshszpn
江	nnhhsh
池	nnhzsz
污	nnhhhz
汢	nnhhsh
汣	nnhpzn
汤	nnhzpp
汥	nnhhszn
汦	nnhpzhz
汧	nnhhhps
汨	nnhszhh
汩	nnhszhh
汪	nnhhhsh
汫	nnhhhps
汭	nnhszpn
汮	nnhpznh
汯	nnhhpzn
汰	nnhhpnn
汱	nnhhpnn
汲	nnhpzn
汳	nnhppzn
汴	nnhnhsn
汵	nnhpnnz
汶	nnhnhpn
汸	nnhnhzp
汹	nnhpnzs
決	nnhzhpn
汻	nnhphhs
汼	nnhphhs
汽	nnhphhz
汾	nnhpnzp
汿	nnhznzs
沀	szpnznzs
沁	nnhnznn
沂	nnhpphs
沃	nnhphpn
沄	nnhhhzn
沅	nnhhhpz
沆	nnhnhpz
沇	nnhznpz
沈	nnhnzpz
沉	nnhnzpz
沋	nnhhpzn
沌	nnhhzsz
沍	nnhhzzh
沎	nnhpspz
沏	nnhhzzp
沐	nnhhspn
沑	nnhzshh
沒	nnhzpzn
沓	szpnszhh
沖	nnhszhs
沗	hhpnsnhpn
沘	nnhhzpz
沙	nnhspnp
沚	nnhshsh
沛	nnhhszs
沜	nnhpshz
沞	nnhhszs
沟	nnhpzzn
沠	nnhppsn
没	nnhpzzn
沢	nnhzhpn
沣	nnhhhhs
沤	nnhhpnz
沥	nnhhpzp
沦	nnhpnpz
沧	nnhpnzz
沨	nnhpzpn
沩	nnhnpzn
沪	nnhnzhp
沫	nnhhhspn
沬	nnhhhspn
沭	nnhhspnn
沮	nnhszhhh
沰	nnhhpszh
沱	nnhnnzpz
沲	nnhphzsz
河	nnhhszhs
沴	nnhpnppp
沵	nnhpzspn
沶	nnhhhspn
沷	nnhhpznn
沸	nnhzhzps
油	nnhszhsh
沺	nnhszhsh
治	nnhznszh
沼	nnhzpszh
沽	nnhhsszh
沾	nnhshszh
沿	nnhpzszh
泀	nnhzhszh
況	nnhszhpz
泂	nnhszszh
泃	nnhpzszh
泄	nnhhsshz
泅	nnhszpnh
泆	nnhphhpn
泇	nnhzpszh
泈	nnhpznnn
泉	pszhhszpn
泊	nnhpszhh
泋	nnhhshps
泌	nnhnznpn
泍	nnhhspnh
泎	nnhphshh
泏	nnhzsszs
泐	nnhzszp
泑	nnhzznzp
泒	nnhppznn
泓	nnhzhzzn
泔	nnhhsshh
法	nnhhshzn
泖	nnhpzpzs
泗	nnhszpzh
泘	nnhpnphs
泙	nnhhnphs
泚	nnhshshpz
泛	nnhpnzn
泜	nnhpzhzn
泝	nnhpphsn
泞	nnhnnzhs
泟	nnhhshsh
泡	nnhpzzhz
波	nnhzpszn
泣	nnhnhnph
泤	nnhznpn
泥	nnhzhppz
注	nnhnhhsh
泪	nnhszhhh
泫	nnhnhzzn
泬	nnhnnzpn
泭	nnhpshsn
泮	nnhnphhs
泯	nnhzhzhz
泰	hhhpnsnhpn
泱	nnhszhpn
泲	nnhpzsp
泳	nnhnzzpn
泴	szpnszssh
泵	hpszhszpn
泶	nnpnzszpn
泷	nnhhpzpn
泸	nnhshzhp
泹	nnhszhhh
泺	nnhpzspn
泻	nnhnzhzh
泼	nnhzpznn
泽	nnhznhhs
泾	nnhznhsh
泿	nnhzhhzpn
洀	nnhppznhn
洁	nnhhshszh
洂	nnhnhpspn
洃	nnhhpnppn
洄	nnhszszhh
洅	nnhhszshh
洆	nnhzszpnh
洇	nnhszhpnh
洈	nnhpzhpzz
洉	nnhpphszh
洊	nnhhpszsh
洋	nnhnphhhs
洌	nnhhpznss
洍	nnhhsszhsz
洎	nnhpszhhh
洏	nnhhpszss
洐	nnhppshhs
洑	nnhpshpnn
洒	nnhhszpzh
洓	nnhhszspn
洔	nnhhshhsn
洕	nnhpnszhh
洖	nnhszhhhpn
洗	nnhphshpz
洘	nnhhshphz
洙	nnhphhspn
洚	nnhpznhzs
洛	nnhpznszh
洝	nnhnnzzph
洞	nnhszhszh
洟	nnhhzhzpn
洠	nnhznphhs
洢	nnhpszhhp
洣	nnhnphspn
洤	nnhpnhhsh
津	nnhzhhhhs
洦	nnhhpszhh
洧	nnhhpszhh
洨	nnhnhpnpn
洩	nnhszhhzp
洪	nnhhsshpn
洫	nnhpszssh
洬	nnhpzhpzn
洭	nnhhhhshz
洮	nnhpnhzpn
洯	hhhszpszpn
洰	nnhhzhz
洱	nnhhsshhh
洲	nnhnpnsns
洳	nnhzphszh
洴	nnhnphhps
洵	nnhpzszhh
洶	nnhpzpnzs
洷	nnhhznhsh
洸	nnhsnphpz
洹	nnhhszhhh
洺	nnhpznszh
活	nnhphsszh
洼	nnhhshhsh
洽	nnhpnhszh
派	nnhpppzpn
洿	nnhhpnhhz
浀	nnhszhssh
流	nnhnhznpsz
浂	nnhnphhpn
浃	nnhhnphpn
浄	nnhpzzhhs
浅	nnhhhzpn
浆	nhspznszpn
浇	nnhhzphpz
浈	nnhshszpn
浉	nnhsphszs
浊	nnhszhshn
测	nnhszpnss
浌	nnhpshzpn
浍	nnhpnhhzn
济	nnhnhpnps
浏	nnhnhpnss
浐	nnhnhnphp
浑	nnhnzhzhs
浒	nnhnzphhs
浓	nnhnzpzpn
浔	nnhzhhhsn
浕	nnhzhpnnn
浖	nnhpnnphsn
浗	nnhhsnhpnn
浘	nnhzhpphhz
浙	nnhhshpphs
浚	nnhznpnpzn
浛	nnhpnnzszh
浜	nnhpshshpn
浝	nnhhpzpppn
浞	nnhszhshpn
浟	nnhpssphpn
浠	nnhpnhpszs
浡	nnhhsnzzsh
浢	nnhhszhnph
浣	nnhnnzhhpz
浤	nnhnnzhpzn
浥	nnhszhzshz
浦	nnhhszhhsn
浧	nnhszhhhsh
浨	nnhnnzhspn
浩	nnhphshszh
浪	nnhnzhhzpn
浫	nnhnzpnhhs
浬	nnhszhhshh
浭	nnhhszhhpn
浮	nnhpnnpzsh
浯	nnhhszhszh
浰	nnhphspnss
浱	nnhhphhzpn
浲	nnhpznhhhs
浳	nnhhznszhh
浴	nnhpnpnszh
浵	nnhpznhppp
浶	nnhnnzphhs
海	nnhphzznhn
浸	nnhzhhnzzn
浹	nnhhpnpnpn
浺	nnhnnsszhs
浻	nnhszpnszh
浼	nnhpzszhpz
浽	nnhpnnpzph
浾	nnhhshpspn
浿	nnhszhhhpn
涀	nnhszhhhpz
涁	nnhhspnppp
涂	nnhpnhhspn
涃	nnhszhspnh
涄	nnhszhshhz
涅	nnhszhhhsh
涆	nnhszhhhhs
涇	nnhhzzzhsh
消	nnhsnpszhh
涉	nnhshshspp
涊	nnhzpnnznn
涋	nnhnnzhpnn
涌	nnhznszhhs
涍	nnhhshpzsh
涎	nnhpshzzn
涏	nnhphshzn
涐	nnhphzhzpn
涑	nnhhszhspn
涒	nnhzhhpszh
涓	nnhszhszhh
涔	nnhszspnnz
涕	nnhnpzhzsp
涖	nnhpsnhnph
涗	nnhpnszhpz
涘	nnhznphhpn
涙	nnhnzhphpn
涚	nnhnpszhpz
涛	nnhhhhphsn
涜	nnhhshnzpz
涝	nnhhssnzzp
涞	nnhhnphspn
涟	nnhhzhsnzn
涠	nnhszhhzsh
涡	nnhszhszpn
涢	nnhszhszpn
涣	nnhpzszhpn
涤	nnhpznhspn
涥	nnhnhszhzs
润	nnhnszhhsh
涧	nnhnszszhh
涨	nnhzhzphzn
涩	nnhzpnshsh
涪	nnhnhnphszh
涫	nnhnnzszhzh
涬	nnhhshnphhs
涭	nnhpnnpnzzn
涮	nnhzhpszsss
涯	nnhhphshhsh
涰	nnhznznznzn
涱	nnhhshhhzpn
液	nnhnhpspznn
涳	nnhnnzpnhsh
涴	nnhnnzpznzz
涵	nnhzsnhpnzs
涶	nnhphshsshh
涷	nnhhszhhspn
涸	nnhszhsszhh
涹	nnhphspnzph
涺	nnhzhphsszh
涻	nnhpnhhsszh
涼	nnhnhszhspn
涽	nnhpzhzszhh
涾	nnhszpnszhh
涿	nnhhpzppnpn
淀	nnhnnzhshpn
淁	nnhnhnphzph
淂	nnhszhhhhsn
淃	nnhnphhpnzz
淄	nnhzzzszhsh
淅	nnhhspnpphs
淆	nnhpnhpszhh
淇	nnhhsshhhpn
淈	nnhzhpzsszs
淉	nnhszhhhspn
淊	nnhpzpshzhh
淋	nnhhspnhspn
淌	nnhsnpszszh
淍	nnhpzhshszh
淎	nnhhhhpnhhs
淏	nnhszhhhhpn
淐	nnhszhhszhh
淑	nnhshhspnzn
淒	nnhhzhhszph
淓	nnhhssnhzp
淔	nnhhsszhhhh
淕	nnhhshpnhsh
淖	nnhshszhhhs
淗	nnhpznphspn
淘	nnhpzphhszs
淙	nnhnnzhhspn
淚	nnhnzhphpnn
淛	nnhphhszsss
淜	nnhpzhhpzhh
淝	nnhpzhhzshz
淞	nnhhspnpnzn
淟	nnhszhsshpn
淠	nnhszhshhps
淡	nnhnppnnppn
淢	nnhhszhhzpn
淣	nnhpshzhhpz
淤	nnhnhzppnnn
淥	nnhzzhsnhpn
淦	nnhpnhhsnph
淧	nnhnnznznpn
淨	nnhpnnpzhhs
淩	nnhhshpnpzn
淪	nnhpnhszhss
淫	nnhpnnpphsh
淬	nnhnhpnpnhs
淭	nnhnzhphspn
淮	nnhpsnhhhsh
淯	nnhnhznszhh
淰	nnhpnnznznn
深	nnhnzpnhspn
淲	nnhshzphzpz
淳	nnhnhszhzsh
淴	nnhpzppnznn
淵	nnhphshzzshs
淶	nnhhpnpnspn
混	nnhszhhhzpz
淸	nnhhhshszsh
淹	nnhhpnszhhz
淺	nnhhzpnhzpn
添	nnhhhpnsnnn
淼	szpnszpnszpn
淽	nnhhssshsh
淾	pnhhsnphszpn
淿	nnhpszhhszs
渀	nnhhpnhshps
渁	nnhszpnszpn
渂	nnhszhhnhpn
渃	nnhhsshpszh
渄	nnhshhhshhh
清	nnhhhshszhh
渆	nnhnphhpsss
渇	nnhszhhpzpz
済	nnhnhpnpshh
渉	nnhshshspnp
渊	nnhpnphspns
渌	nnhzhhsnhpn
渍	nnhhhshszpn
渎	nnhhsznnhpn
渏	nnhhpnhszhs
渐	nnhhzshpphs
渑	nnhszhszhhz
渒	nnhpszhhphs
渓	nnhpnnphhpn
渔	nnhpzszhshh
渕	nnhnphhpnss
渖	nnhnnzszhhs
渗	nnhznhpnppp
渘	nnhznzsphspn
渙	nnhpzszpnhpn
渚	nnhhshpszhh
減	nnhhphszhzpn
渜	nnhhpszsshpn
渝	nnhpnhszhhss
渞	nnhnphpszhhh
渟	nnhnhszhnzhs
渠	nnhhzhzhspn
渡	nnhnhphsshzn
渢	nnhpzpszhshn
渣	nnhhspnszhhh
渤	nnhhsnzzshzp
渥	nnhzhphznhsh
渦	nnhszzszszh
渧	nnhnhnpnzszs
渨	nnhszhshhzpn
温	nnhszhhszssh
渪	nnhpszhszshn
渫	nnhhsshzhspn
測	nnhszhhhpnss
渭	nnhszhshszhh
渮	nnhhsshszhs
港	nnhhsshpnzhz
渰	nnhpnhszhhps
渱	nnhszhshnhsh
渲	nnhnnzhszhhh
渳	nnhzhzhsshhh
渴	nnhszhhpzpnz
渵	nnhhssszhsh
渶	nnhhssszhpn
渷	nnhnhpnszhpz
游	nnhnhzpphzsh
渹	nnhpznhhhszh
渺	nnhszhhhspnp
渻	nnhspnpszhhh
渼	nnhnphhshhpn
渽	nnhhshszhzpn
渾	nnhnzhszhhhs
渿	nnhhspnhhspn
湀	nnhznppnhhpn
湁	nnhhshpnhszh
湂	nnhszhszhhhz
湃	nnhphhphhhhs
湄	nnhzshpszhhh
湅	nnhhsznphspn
湆	nnhnhnphszhh
湇	nnhnhnphszhh
湈	nnhhsshhhspn
湉	nnhnnsphsszh
湊	nnhhhhpnhhpn
湋	nnhzshszhhzs
湌	nnhpnnzhhzpn
湍	nnhszshpszss
湎	nnhhpszsshhh
湏	nnhhpszhhhpn
湐	nnhhspnpszhh
湑	nnhzshpnszhh
湒	nnhszhhsshhh
湓	nnhpnzpszssh
湔	nnhnphszhhss
湕	nnhzhhhhszn
湖	nnhhsszhpzhh
湗	nnhhshhshhsn
湘	nnhhspnszhhh
湙	nnhnhpspnhpn
湚	nnhpzznszhhz
湛	nnhhsshhhpnz
湜	nnhszhhhshpn
湝	nnhhzpzpszhh
湞	nnhshszhhhpn
湟	nnhpszhhhhsh
湠	nnhszshpnppn
湡	nnhszhhszshn
湢	nnhhszhszhsh
湣	nnhzhzhzszhh
湤	nnhnhzpphzsz
湥	nnhnnzpnhpnn
湦	nnhszhhphhsh
湧	nnhznszhhszp
湨	nnhszhhhhpnn
湩	nnhphszhhshh
湪	nnhzzhpzpppn
湫	nnhphspnnppn
湬	phspnnppnszpn
湭	nnhnphszpzhh
湮	nnhhszsshhsh
湯	nnhszhhhpzpp
湰	nnhpznhphhsh
湱	nnhhhhshpszh
湲	nnhpnnphhpzn
湳	nnhhssznphhs
湴	nnhnphssnph
湵	nnhnphhshpzn
湶	nnhpszhhszpn
湷	nnhhhhpnszhh
湸	nnhnhszhnzpz
湹	nnhhpszhhshh
湺	nnhpsszhhspn
湻	nnhnhszhszhh
湼	nnhpshzhhhsh
湽	nnhzzzhszhsh
湾	nnhnhsspnzhz
湿	nnhszhhssnph
満	nnhhsshszszs
溁	nnhhssnzhspn
溂	nnhhszhspnss
溃	nnhszhshszpn
溄	nnhszspznhhs
溅	nnhszpnhhzpn
溆	nnhpnhhspnzn
溇	nnhnphspnzph
溈	nnhnpzzznnnn
溉	nnhzhhznhzpz
溊	nnhzhshhzhzn
溋	nnhzpznszssh
溌	nnhznppnhhpz
溍	nnhhssnphszhh
溎	nnhhspnhshhsh
溏	nnhnhpzhhsszh
源	nnhhppszhhspn
溑	nnhsnpszhhhpn
溒	nnhhshszhpzpn
溓	nnhnphzhhsspn
溔	nnhnphhshnnnn
溕	nnhnzhhpzpppn
準	nnhpsnhhhshhs
溗	nnhphsshhpzpn
溘	nnhhshznszssh
溙	nnhhhhpnsnhpn
溚	nnhhsspnhszh
溛	nnhnnzpnppznn
溜	nnhpznzpszhsh
溝	nnhhhsshszshh
溞	nnhznnszhshn
溟	nnhnzszhhnhpn
溠	nnhnphhhphsh
溡	nnhszhhhshhsn
溢	nnhnphpnszssh
溣	nnhpspnhszhss
溤	nnhhshhsznnnn
溥	nnhhszhhsnhsn
溦	nnhszshpzphpn
溧	nnhhszsshhspn
溨	nnhhshhspnzpn
溩	nnhpszhhznnnn
溪	nnhpnnpzznhpn
溫	nnhszpnhszssh
溬	nnhnphhhpzzn
溭	nnhszhshpnpzn
溮	nnhpszhzhhszs
溯	nnhnphzsppzhh
溰	nnhszshszhnph
溱	nnhhhhpnphspn
溲	nnhpshzhhszn
溳	nnhszhszhhhpn
溴	nnhpszhhhhpnn
溵	nnhppzhhzpzzn
溶	nnhnnzpnpnszh
溷	nnhszhpzpppnh
溸	nnhhhshzznspn
溹	nnhhsnzzznspn
溺	nnhzhznhzhznh
溻	nnhszhhznhznh
溼	nnhhzznzznhsh
溽	nnhhphhzpnhsn
溾	nnhpszhhpzzn
溿	nnhszhshnphhs
滀	nnhnhzznszhsh
滁	nnhzspnhhspn
滂	nnhnhnpnznhzp
滃	nnhpnznznhznh
滄	nnhpnnzhhpszh
滅	nnhhphnppnzpn
滆	nnhhszhsznphs
滇	nnhhsszhhhhpn
滈	nnhnhszhszszh
滉	nnhszhhsnphpz
滊	nnhphhznphspn
滋	nnhnphzznzzn
滌	nnhpsspznhspn
滍	nnhzsshszhshn
滎	nppnnppnnzszpn
滏	nnhpnpnhhsnph
滐	nnhpznhzshspn
滑	nnhszznzszhh
滒	nnhhszhshszhs
滓	nnhnnznhnphhs
滔	nnhpnnppshzhh
滕	pzhhnphhpnsnhpn
滖	nnhnhszhhpzpn
滗	nnhphnphnphhz
滘	nnhnzpnhshszh
滙	nnhhpsnhhhshz
滚	nnhnhpnznpzpn
滛	nnhpnnpphhszs
滜	nnhpszhhhpnhs
滝	nnhnhnphszhhz
滞	nnhhsssnzszs
滟	nnhhhhspzzshz
滠	nnhhsshhhznzn
满	nnhhsshszpnpn
滢	nnhhssnzhhshn
滣	nnhhphhzpnszh
滤	nnhshzphznznn
滥	nnhssphnszssh
滦	nnhnhsspnhspn
滧	nnhnhpnpnphpn
滨	nnhnnzpshshpn
滩	nnhznpsnhhhsh
滪	nnhznzshpszpn
滫	nnhpsspznszhh
滬	nnhnzhpszhzshz
滭	nnhszhhhsshhs
滮	nnhshzphzpzppp
滯	nnhhpsshznzszs
滰	nnhnhnphszhhpz
滱	nnhnnzhhpzshzn
滲	nnhznznznpnppp
滳	nnhnhnpszpnszh
滴	nnhnhnpszhsszh
滵	nnhnnznznpnszs
滶	nnhhhshzpphpn
滷	nnhshszpnnnnnh
滸	nnhnhhhszhphhs
滹	nnhshzphzpnphs
滺	nnhpssphpnnznn
滻	nnhnhnphpphhsh
滼	nnhhspnhspnpzn
滽	nnhnhpzhhszhhs
滾	nnhnhpnszhpzpn
滿	nnhhsshszspnpn
漀	hshzshppzznszpn
漁	nnhpzszhshnnnn
漂	nnhhszsshhhspn
漃	nnhnnzshhspnzn
漄	nnhszshphshhsh
漅	nnhzzzszhhhspn
漆	nnhhspnpnsnhpn
漇	nnhppsshshshpn
漈	nnhpznnznhhspn
漉	nnhnhpzsshhzpz
漊	nnhszhhszhszph
漋	nnhzspznhphhsh
漌	nnhhsshszhhhsh
漍	nnhszhszhhzpnh
漎	nnhppspnpnshpn
漏	nnhzhphszsnnnn
漐	hshnphhspznszpn
漑	nnhpszhhpzhzpz
漒	nnhzhzszhszhshn
漓	nnhnhpnzsszzn
演	nnhnnzhszhshpn
漕	nnhhszhsshszhh
漖	nnhhshpzshphpn
漗	nnhpszpznhnznn
漘	nnhhphhzpnszhh
漙	nnhhszhhshnhsn
漚	nnhhszhszhszhz
漛	nnhnphhpnsnhpn
漜	nnhhspnhspnhsh
漝	nnhznhznhpszhh
漞	nnhpnnpszhhhpz
漟	nnhsnpnzszhhsh
漠	nnhhssszhhhpn
漡	nnhphszhhhpzpp
漢	nnhhsshszhhhpn
漤	nnhhspnhspnzph
漥	nnhnnzpnhshhsh
漧	nnhhsszhhhsphz
漨	nnhpznhhhsnzn
漩	nnhnhzpphzshpn
漪	nnhpzphpnhszhs
漫	nnhszhhszsshzn
漬	nnhhhshszhhhpn
漭	nnhhsshpnnhps
漮	nnhnhpzhhsnhpn
漯	nnhszhshzznspn
漰	nnhszspzhhpzhh
漱	nnhhszhspnpzpn
漲	nnhzhzhshhhzpn
漳	nnhnhnphszhhhs
漴	nnhszsnnzhhspn
漵	nnhpnhhspnphpn
漶	nnhszhszhsnznn
漷	nnhnhszhzshzs
漸	nnhhszhhhspphs
漹	nnhhshshhznnnn
漺	nnhhpnpnpnpnpn
漻	nnhznhznhpnppp
漼	nnhszspsnhhhsh
漽	nnhzhpsnhpnphhs
漾	nnhnphhshnzzpn
漿	zshppznnhsnszpn
潁	pzszpnhpszhhhpn
潄	nnhhszhspnphpn
潆	nnhhssnzzznspn
潇	nnhhsszhhspspn
潉	nnhszsszhhhzpz
潋	nnhpnhnnphphpn
潌	nnhnnzpnhznhsh
潍	nnhzzhpsnhhhsh
潎	nnhnpszspnphpn
潏	nnhznzspszpnszh
潐	nnhpsnhhhshnnnn
潑	nnhznppnzhzpzzn
潒	nnhpzszhpzpppn
潓	nnhhszhhshnnznn
潔	nnhhhhszpzznspn
潖	nnhhhshhhshzshz
潗	nnhpsnhhhshhspn
潘	nnhpnphspnszhsh
潚	nnhzhhspshhzzshs
潛	nnhhzpzhzpzszhh
潜	nnhhhpnhhpnszhh
潝	nnhpnhszhznhznh
潞	nnhszhshshpznszh
潠	nnhzhzzhzhsshpn
潡	nnhnhszhzshphpn
潢	nnhhsshszhshpn
潥	nnhhszsshnphspn
潦	nnhhpnnpszhhspn
潧	nnhnpszsnphszhh
潪	nnhphhpnszhszhh
潬	nnhszhszhszhhhs
潭	nnhhszsshszhhhs
潮	nnhhsszhhhspzhh
潰	nnhszhshszhhhpn
潲	nnhphspnsnpszhh
潳	nnhzhphshpszhh
潴	nnhpzphshpszhh
潵	nnhhsshszhhphpn
潶	nnhsznphshhnnnn
潺	nnhzhpzshzshzsh
潻	nnhphspnpnsnhpn
潼	nnhnhnphszhhshh
潽	nnhnphssnphszhh
潾	nnhnphspnpznhzs
澂	nnhszshhhshphpn
澄	nnhznppnhszhnph
澈	nnhnhznszhhphpn
澉	nnhzhsshhhphpn
澊	nnhnphszpzhhhsn
澋	nnhszhhnhszhspn
澌	nnhhsshhhpnpphs
澎	nnhhshszhnphppp
澒	nnhhshhpszhhhpn
澓	nnhppsphszhhpzn
澔	nnhpszhhphshszh
澕	nnhhsshhsshhs
澚	nnhpsznphspnhz
澛	nnhpzszhshhszhh
澜	nnhnszhsznphspn
澟	nnhnhszszhhphspn
澡	nnhszhszhszhhspn
澥	nnhpzpzhhszpphhs
澦	nnhznzshpszhhhpn
澨	nnhphnphnhspnpnh
澪	nnhhnzsnnnnpnnzn
澭	nnhnhzzppsnhhhsh
澮	nnhpnhszsnphszhh
澯	nnhshpznznnphspn
澰	nnhpnhszhszhpnpn
澱	nnhzhphsshpnpzzn
澲	nnhssnphnphhhspn
澳	nnhpsznphspnhpn
澴	nnhszsshhszhpzpn
澵	nnhnhnphhspnpphs
澶	nnhnhszszhhszhhh
澷	nnhszhhszsshnhzp
澸	nnhhphszhzpnnznn
澹	nnhpzhppnnhhhszh
澺	nnhnhnphszhhnznn
澻	nnhnphpzpppnnzn
澼	nnhzhpszhnhnphhs
澿	nnhhspnhspnhhspn
激	nnhpszhhnhzpphpn
濂	nnhnhpnphzhhsspn
濆	nnhhshssszhhhpn
濉	nnhszhhhpsnhhhsh
濋	nnhhspnhspnzshpn
濎	nnhszhhhzhpshsz
濐	nnhszhhhshpszhh
濑	nnhhszhspnpzszpn
濒	nnhshshspphpszpn
濓	nnhnhnphpzhhsspn
濔	nnhhpnszspnpnpnpn
濖	nnhszsshhshpszhh
濗	nnhhssszhhhpnszs
濘	nnhnnznznnszsshhs
濛	nnhhssnzhhpzpppn
濞	nnhpszhhhszhshhps
濠	nnhnhszhnzhpzpppn
濡	nnhhnzsnnnnhpszss
濢	nnhznhznhnhpnpnhs
濣	nnhhsszhhhspnnnhs
濨	nnhnphzznzznnznn
濩	nnhhsspsnhhhshzn
濪	nnhhhshszhhpzzshz
濫	nnhhszhszphnszssh
濬	nnhshnzhpnpnszhhh
濭	nnhhsshshznszssh
濮	nnhpsssnphnphhhpn
濯	nnhznhznhpsnhhhsh
濰	nnhzznnnnpsnhhhsh
濲	nnhhshnzphspnpzzn
濳	nnhphshpzphshpzszhh
濺	nnhszhhhpnhzpnhzpn
濽	nnhhhpnhhpnszhhhpn
瀂	nnhpzszhshnnnnszhh
瀃	nnhszhhhpnszhhpzpp
瀌	nnhnhpzsshhzpznnnn
瀎	nnhhssszsshhpnzpn
瀐	nnhhshshhhshhhhzpn
瀑	nnhszhhhsshpnsnhpn
瀓	nnhppsszshhhshphpn
瀔	nnhhshnzhphspnpzzn
瀕	nnhshshspphpszhhhpn
瀖	nnhhnzsnnnnpsnhhhsh
瀚	nnhhsszhhhspnznhznh
瀛	nnhnhzszhpzhhzphpzn
瀜	nnhhszhsznphsszhshn
瀝	nnhhpphspnphspnshsh
瀞	nnhhhshszhhpzzhhs
瀢	nnhszhshszhhhpnnzn
瀣	nnhshpznznshhhshhhh
瀨	nnhhszhspnpzszhhhpn
瀬	nnhhszhspnhpszhhhpn
瀮	nnhhnzsnnnnhspnhspn
瀯	nnhnppnnppnnzszhszh
瀴	nnhszhhhpnszhhhpnzph
瀸	nnhpnpnhshhhshhhhzpn
瀻	nnhhshszhshhsshpnzpn
瀼	nnhnhszhszhhhsshpzpn
灀	nnhhnzsnnnnhspnszhhh
灂	nnhpnnpszsshzhhznhsn
灈	nnhszhhhszhhhpsnhhhsh
灌	nnhhssszhszhpsnhhhsh
灏	nnhszhhnhszhspnhpszpn
灜	nnhnhzszhpzhhszhhhpnpzn
灝	nnhszhhnhszhspnhpszhhhpn
灞	nnhhnzsnnnnhsshszhhspzhh
灢	nnhhszhsnzszhszhhhsshpzpn
灨	nnhnhnphszhhhspznhshszhhhpn
火	nppn
灭	hnppn
灯	nppnhs
灰	hpnppn
灱	nppnzp
灴	nppnhsh
灵	zhhnppn
灶	nppnhsh
灸	pznnppn
灹	nppnphz
灺	nppnzsz
灼	nppnpzn
灾	nnznppn
灿	nppnszs
炀	nppnzpp
炂	nppnpnzn
炃	pnzpnppn
炄	nppnzshh
炅	szhhnppn
炆	nppnnhpn
炇	nppnphpn
炈	nppnpzzn
炉	nppnnzhp
炊	nppnpzpn
炋	nppnhpsn
炌	nppnpnps
炍	nppnppzn
炎	nppnnppn
炏	nppnnppn
炐	nppnhhhs
炑	nppnhspn
炒	nppnspnp
炓	nppnnnhs
炔	nppnzhpn
炕	nppnnhpz
炖	nppnhzsz
炗	hsshnppn
炘	nppnpphs
炙	pznnnppn
炚	szhhnppn
炛	nppnpspz
炜	nppnhhzs
炝	nppnpnzz
炞	nppnnhsn
炟	nppnszhhh
炠	nppnszhhs
炡	nppnhshsh
炢	nppnhspnn
炣	nppnhszhs
炤	nppnzpszh
炥	nppnzhzps
炦	nppnhpznn
炧	nppnphzsz
炨	nppnnnzpz
炩	nppnpnnzn
炪	nppnzsszs
炫	nppnnhzzn
炬	nppnhzhz
炭	szshpnppn
炮	nppnpzzhz
炯	nppnszszh
炰	pzzhznnnn
炱	znszhnppn
炲	nppnznszh
炳	nppnhszpn
炴	nppnszhpn
炵	nppnpznnn
炶	nppnshszh
炷	nppnnhhsh
炸	nppnphshh
点	shszhnnnn
為	npzzznnnn
炻	nppnhpszh
炼	nppnhzzpn
炽	nppnszhpn
炾	nppnszhpz
炿	nppnppznh
烀	nppnpnphs
烁	nppnpzspn
烂	nppnnphhh
烃	nppnznhsh
烄	nppnnhpnpn
烅	nppnpszssh
烆	nppnppshhs
烇	nppnpnhhsh
烈	hpznssnnnn
烉	pzszpnnppn
烊	nppnnphhhs
烋	pshspnnnnn
烌	nppnpshspn
烍	nppnphshpz
烎	hhpsnppn
烏	pszhhznnnn
烐	nppnppznhn
烑	nppnpnhzpn
烒	nppnhhshzn
烓	nppnhshhsh
烔	nppnszhszh
烕	hphnppnzpn
烖	hshnppnzpn
烗	nppnnhzppn
烘	nppnhsshpn
烙	nppnpznszh
烚	nppnpnhszh
烛	nppnszhshn
烜	nppnhszhhh
烝	zszpnhnnnn
烞	nppnhspnsn
烟	nppnszhpnh
烠	nppnhpszhh
烡	nppnhsshpn
烢	nppnnnzphz
烣	nppnhpnppn
烤	nppnhshphz
烥	nppnhszhsz
烦	nppnhpszpn
烧	nppnhzphpz
烨	nppnpspzhs
烩	nppnpnhhzn
烪	nppnnphhpn
烫	nnhzppnppn
烬	nppnzhpnnn
热	hshpznnnnn
烮	hpznssnppn
烯	nppnpnhpszs
烰	nppnpnnpzsh
烱	nppnszpnszh
烲	hshpphsnppn
烳	nppnhszhhsn
烴	nppnhzzzhsh
烵	nppnhsspzn
烶	nppnphshzn
烷	nppnnnzhhpz
烸	nppnphzznhn
烹	nhszhzsnnnn
烺	nppnnzhhzpn
烻	nppnpshzzn
烼	nppnhpzpppn
烽	nppnpznhhhs
烾	nppnnppnhsh
烿	nppnpznhppp
焀	nppnpnpnszh
焁	szhpzpnnppn
焂	pssphpnnppn
焃	nppnhshpspn
焄	zhhpszhnnnn
焅	nppnphshszh
焆	nppnszhszhh
焇	nppnsnpszhh
焈	nzhpzhznppn
焉	hshshhznnnn
焊	nppnszhhhhs
焋	zshphshnppn
焌	nppnznpnpzn
焍	nppnnpzhzsp
焎	hshpphsnnnn
焏	zsszhznnnnn
焐	nppnhszhszh
焑	nppnszhspnh
焒	nppnszhszh
焓	nppnpnnzszh
焔	nppnpzsszhh
焕	nppnpzszhpn
焖	nppnnsznznn
焗	nppnzhpzszh
焘	hhhphsnnnnn
焙	nppnnhnphszh
焚	hspnhspnnppn
焛	szhhszhhnppn
焜	nppnszhhhzpz
焝	nppnpzhzszhh
焞	nppnnhszhzsh
焟	nppnhsshszhh
焠	nppnnhpnpnhs
無	phhsssshnnnn
焢	nppnnnzpnhsh
焣	hsshhhznnnnn
焤	nhppshsnnppn
焥	nppnnnzpznzz
焦	psnhhhshnnnn
焧	nppnpnznnznn
焨	nppnszhhszhh
焩	nppnpzhhpzhh
焪	nppnnnzpnzhz
焫	nppnhssszpn
焬	nppnszhhpzpp
焭	nppnnppnnzpz
焮	nppnpphspzpn
焯	nppnshszhhhs
焰	nppnpzpshzhh
焱	nppnnppnnppn
焲	nppnnhpspznn
焳	nppnpsnhhhsh
焴	nppnnhznszhh
焵	nppnsznphszs
然	pznnhpnnnnnn
焷	nppnpszhhphs
焸	szhhszhhnppn
焹	nppnsznphnhz
焺	nppnszhhphps
焻	nppnszhhszhh
焼	nppnhshsshpz
焽	szhhpzhhnppn
焾	nppnpnnznznn
焿	nppnnhpzhhpn
煀	nppnzhpzsszs
煁	nppnhsshhhpnz
煂	nppnhsshszhhs
煃	nppnhpnhshhsh
煄	nppnphszhhshh
煅	nppnpshhhpzzn
煆	nppnzhshhzhzn
煇	nppnnzhszhhhs
煈	nppnpzpszhshn
煉	nppnhsznphspn
煊	nppnnnzhszhhh
煋	nppnszhhphhsh
煌	nppnpszhhhhsh
煍	nppnphspnnppn
煎	nphszhhssnnnn
煏	nppnhszhszhsh
煐	nppnhssszhpn
煑	hshpszhhnppn
煒	nppnzshszhhzs
煓	nppnszshpszss
煔	nppnnppnshszh
煕	hzhsszzhznnnn
煖	nppnpnnphhpzn
煗	nppnhpszsshpn
煘	nppnhphszhzpn
煙	nppnhszsshhsh
煚	szhhhzhznppn
煛	szhhhszhhhnppn
煜	nppnszhhnhnph
煝	nppnzshpszhhh
煞	pzzhhphpnnnnn
煟	nppnszhshszhh
煠	nppnhsshzhspn
煡	nppnzhhhhszn
煢	nppnnppnnzzhs
煣	nppnznzsphspn
煤	nppnhsshhhspn
煥	nppnpzszpnhpn
煦	szhhpzszhnnnn
照	szhhzpszhnnnn
煨	nppnszhshhzpn
煩	nppnhpszhhhpn
煪	nppnnphszpzhh
煫	nppnnphpzpppn
煬	nppnszhhhpzpp
煭	zzzhpznssnnnn
煮	hshpszhhnnnn
煯	nppnhzpzpszhh
煰	nppnszhszhszh
煱	nppnszzszszh
煲	psszhhspnnppn
煳	nppnhsszhpzhh
煴	nppnszhhszssh
煵	nppnhssznphhs
煶	nppnszhhhshpn
煷	nppnnhszhnzpz
煸	nppnnzhpszhss
煹	nppnhhsshszshh
煺	nppnzhhzpnnzn
煻	nppnnhpzhhsszh
煼	nppnpzzsppzzsp
煽	nppnnzhpznhznh
煾	nppnszhpnhnznn
煿	nppnhszhhsnhsn
熀	nppnszhhsnphpz
熁	nppnzpzpzpszhh
熂	nppnphhznphspn
熃	znzsppznzpnppn
熄	nppnpszhhhnznn
熅	nppnszpnhszssh
熆	nppnhshznszssh
熇	nppnnhszhszszh
熈	phszhszzhznnnn
熉	nppnszhszhhhpn
熊	znszhhpzpznnnn
熋	znszhhpzpznppn
熌	nppnszhhszhhpn
熍	nppnnnzszhszh
熎	nppnpnnpphhszs
熏	phsznphshhnnnn
熐	nppnnzszhhnhpn
熑	nppnnphzhhsspn
熒	nppnnppnnznppn
熓	nppnpszhhznnnn
熔	nppnnnzpnpnszh
熕	nppnhshszhhhpn
熖	nppnpnnppshzhh
熗	nppnpnnzhhpszh
熘	nppnpznzpszhsh
熙	hsszhszzhznnnn
熚	nppnszhhhsshhs
熛	nppnhszsshhhspn
熜	nppnpszpznhnznn
熝	nppnnhpzsshhzpz
熞	nppnhszhszznhsh
熟	nhszhzshpznnnnn
熠	nppnznhznhpszhh
熡	nppnszhhszhszph
熢	nppnpznhhhsnzn
熣	nppnszspsnhhhsh
熤	nppnznhznhnhnph
熥	nppnznszhhsnzn
熦	nppnspnpsnhhhsh
熧	ppspnpnshpnnppn
熨	zhphhspnhsnnppn
熩	nppnnzhpszhzshz
熪	nppnphspnpznpzn
熫	nppnnhphsshnnnn
熬	hhshzpphpnnnnn
熭	hhhshhhszhhnppn
熮	nppnznhznhpnppp
熯	nppnhsshszhhhpn
熰	nppnhszhszhszhz
熱	hshpnhshpznnnnn
熲	pznppnhpszhhhpn
熳	nppnszhhszsshzn
熴	nppnszsszhhhzpz
熵	nppnnhnpszpnszh
熶	nppnszhhhsshhhzn
熷	nppnnpszsnphszhh
熸	nppnhzpzhzpzszhh
熹	hshszhnphszhnnnn
熺	nppnhshszhnphszh
熻	nppnpnhszhznhznh
熼	nppnszhshhsshpn
熽	nppnzhhspshhzzshs
熾	nppnnhnphszhhzpn
熿	nppnhsshszhshpn
燀	nppnszhszhszhhhs
燁	nppnhsshhsshhs
燂	nppnhszsshszhhhs
燃	nppnpznnhpnnnnnn
燄	pzpshzhhnppnnppn
燅	hshpnhshnppnnppn
燆	nppnphpnszhszszh
燇	nppnnphszpzhhhsn
燈	nppnznppnhszhnph
燉	nppnnhszhzshphpn
燊	nppnnppnnppnhspn
燋	nppnpsnhhhshnnnn
燌	nppnhshssszhhhpn
燍	nppnhsshhhpnpphs
燎	nppnhpnnpszhhspn
燏	nppnznzspszpnszh
燐	nppnnphspnpznhzs
燑	nppnnhnphszhhshh
燒	nppnhshhshhshhpz
燓	hspnpnpnhspnnppn
燔	nppnpnphspnszhsh
燕	hsshszhshhpznnnn
燖	nppnzhhhshszhhsn
燗	nppnszhhszhhpzhh
燘	nppnszhhszhhnhpn
燙	nnhszhhhpzppnppn
燚	nppnnppnnppnnppn
燛	hshzsshhszhsznppn
燜	nppnszhhszhhnznn
燝	nppnszhhnhszhspn
燞	psnhhhshpzpnnnnn
營	nppnnppnnzszhszh
燠	nppnpsznphspnhpn
燡	nppnszsshhshnphhs
燢	pshhpnpnzhhnznppn
燣	nppnnhszszhhphspn
燤	nppnhssszhhszshn
燥	nppnszhszhszhhspn
燦	nppnshpznznnphspn
燧	nppnnphpzpppnnzn
燨	nppnnphhshphshzpn
燩	nppnpszhhnhzpphpn
燪	nppnhsspzppnnznn
燫	nppnnhpnphzhhsspn
燬	nppnpshzhhhshpzzn
燭	nppnszsshpzszhshn
燮	nhhhszhnppnnppnzn
燯	nppnhnzsnnnnpnnzn
燰	nppnpnnpnznznnpzn
燱	nppnnhnphszhhnznn
燲	nppnzpzpzpszhhhpn
燳	nppnszhhzpszhnnnn
燴	nppnpnhszsnphszhh
燵	nppnhshnphhhsnzn
燶	nppnszhsshhphhzpn
燷	nppnnhszszhhhhspn
燸	nppnhnzsnnnnhpszss
燹	hpzpppnhpzpppnnppn
燺	nppnnhszhszszhhspn
燻	nppnphsznphshhnnnn
燼	nppnzhhshnnnnszssh
燽	nppnhshzhshhszhhsn
燾	hshzhshhszhhsnnnnn
燿	nppnznhznhpsnhhhsh
爀	nppnhshpspnhshpspn
爁	nppnhszhszphnszssh
爂	pshhszhszhzhhnznppn
爃	nppnnppnnppnnzhspn
爄	nppnhphssszhhszshn
爅	nppnsznphshhnnnnhsh
爆	nppnszhhhsshpnsnhpn
爇	hsshshpnhshpznnnnn
爈	nppnshzphzszhshnznn
爉	nppnzzzszpnhznnznnz
爊	nppnnhpzsshhzpznnnn
爋	nppnphsznphshhzpnnnn
爌	nppnnhphsshszhshpn
爍	nppnpszhhzznzznhspn
爎	nppnnnzhpnnpszhhspn
爏	nppnhpphspnphspnshsh
爐	nppnshzphzszhshszssh
爑	nppnhsspsnhhhshnnnn
爒	pznnnppnhpnnpszhhspn
爓	nppnszhhszhhpzpshzhh
爔	nppnnphhshphspnhzzpn
爕	nhhhszhnppnnppnnppn
爖	nppnnhnphszhhshzhzhhh
爗	nppnszhhhsshhsshhs
爘	nppnshpznznpnnzhhzpn
爙	nppnnhszhszhhhsshpzpn
爚	nppnpnhszhszhszhszhss
爛	nppnszhhszhhhsznphspn
爜	nppnssnphnphhshsshhhzn
爝	nppnpnnpszsshzhhznhsn
爞	nppnszhshnszhshnszhshn
爟	nppnhssszhszhpsnhhhsh
爠	nppnszhhhszhhhpsnhhhsh
爡	nppnhssszhhszshnszhshn
爢	nhphspnhspnshhhshhhnnnn
爣	nppnsnpnzszhsznphshhnnnn
爤	nppnhssszhhszhhhsznphspn
爥	nppnzhpsnhpnszsshpzszhshn
爦	nppnhszhszphnszsshszhhhpz
爧	nppnhnzsnnnnszhszhszhhspnpnh
爨	pshhszhszhzhhnzhspnhspnhpnnppn
爩	nppnhspnphhszshspnnzpnnnnnzshzppp
爪	ppsn
爬	ppsnzshz
爭	pnnpzhhs
爮	ppsnpzzhz
爯	pnnpszshh
爰	pnnphhpzn
爱	pnnpnzhpzn
爲	pnnppzzznnnn
爳	pnnppzzznnnnzs
爴	szhszhhzpnhppsn
爵	pnnpszsshzhhznhsn
父	pnpn
爷	pnpnzs
爸	pnpnzshz
爸	pnnpzshz
爹	pnpnpznpzn
爺	pnpnhsshhhzs
爻	pnpn
爼	pnpnszhhh
爽	hpnpnpnpnpn
爾	hpnszspnpnpnpn
爿	zshp
牀	zshphspn
牁	zshphszhs
牂	zshpnphhhs
牃	zshphsshzhspn
牄	zshppnnzhhpszh
牅	zshpnhpzhhszhhs
牆	zshphspnpnhszszhh
片	pshz
版	pshzppzn
牉	pshznphhs
牊	pshzzpszh
牋	pshzhzpnhzpn
牌	pshzpszhhphs
牍	pshzhsznnhpn
牎	pshzpzppnnznn
牏	pshzpnhszhhss
牐	pshzphspshzhh
牑	pshznzhpszhss
牒	pshzhsshzhspn
牓	pshznhnpnznhzp
牔	pshzhszhhsnhsn
牕	pshzpszpznhnznn
牖	pshznzhphszhhsn
牗	pshznhpzhhszhhs
牘	pshzhshszsshszhhhpn
牙	hzsp
牚	snpnzszhhzsp
牛	phhs
牝	phshpz
牞	phshzp
牟	znphhs
牠	phshzsz
牡	phshhsh
牢	nnzphhs
牣	phshzpn
牤	phshnhz
牥	phshnhzp
牦	phshphhz
牧	phshphpn
牨	phshnhpz
物	phshpzpp
牪	phshphhs
牫	phshhzpn
牬	phshpzsp
牭	phshszpzh
牮	pshznphhs
牯	phshhsszh
牰	phshszhsh
牱	phshhszhs
牲	phshphhsh
牳	phshzznhn
牴	phshpzhzn
牵	hpnnzphhs
牶	nphhpnphhs
牷	phshpnhhsh
牸	phshnnzzsh
特	phshhshhsn
牺	phshhszpzh
牻	phshhpzpppn
牼	phshhzzzhsh
牽	nhzznnzphhs
牾	phshhszhszh
牿	phshphshszh
犀	zhpsnhpnphhs
犁	phspnssphhs
犂	phspnpzpphhs
犃	phshnhnphszh
犄	phshhpnhszhs
犅	phshsznphszs
犆	phshhsszhhhh
犇	phhsphshphhs
犈	phshnphhpnzz
犉	phshnhszhzsh
犊	phshhsznnhpn
犋	phshszhhhhpn
犌	phshzhshhzhzn
犍	phshzhhhhszn
犎	hshhshhsnphhs
犏	phshnzhpszhss
犐	phshphspnnnhs
犑	phshszhhhhpnn
犒	phshnhszhszszh
犓	phshpzzsppzzsp
犔	phshphhznphspn
犕	phshhsshpszhhs
犖	nppnnppnnzphhs
犗	phshnnzhhhsszh
犘	nhphspnhspnphhs
犙	phshznznznpnnnn
犚	zhphhspnhsnphhs
犛	hhspnphpnhpphhs
犜	phshphszhzshphpn
犝	phshnhnphszhhshh
犞	phshphpnszhszszh
犟	zhzszhszhshnphhs
犠	phshnphhshphshzpn
犡	phshhphssszhhszshn
犢	phshhshszsshszhhhpn
犣	phshzzzszpnhznnznnz
犤	phshszsshznszhhpzpz
犥	phshnhpzsshhzpznnnn
犦	phshszhhhsshpnsnhpn
犧	phshnphhshphspnhzzpn
犨	psnhhhshpsnhhhshphhs
犩	phspnzphpszhhpzznphhs
犪	phshnphpszhhhshshzhzpnpzn
犫	psnhhhshnhhhszhpsnhhhshphhs
犬	hpnn
犯	pzpzz
犰	pzppz
犱	pzppzn
犲	pzphsp
犳	pzppzn
犴	pzphhs
犵	pzpphz
状	nhshpnn
犷	pzpnhp
犸	pzpzzh
犹	pzphpzn
犺	pzpnhpz
犻	pzphszs
犼	pzpzshz
犽	pzphzsp
犾	pzphpnn
犿	pzpnhsn
狀	zshphpnn
狁	pzpznpz
狂	pzphhsh
狃	pzpzshh
狄	pzpnppn
狅	pzpphsh
狆	pzpszhs
狇	pzphspn
狈	pzpszpn
狉	pzphpsnh
狊	szhhhhpnn
狋	pzphhspn
狌	pnpphhsh
狍	pzppzzhz
狎	pzpszhhs
狏	pzpphzsz
狐	pzpppznn
狑	pzppnnzn
狒	pzpzhzps
狓	pzpzpszn
狔	pzpzhppz
狕	pzpzznzp
狖	pzpnnzpn
狗	pzppzszh
狘	pzphzzpn
狙	pzpszhhh
狚	pzpszhhh
狛	pzppszhh
狜	pzphsszh
狝	pzppzspn
狞	pzpnnzhs
狟	pzphszhhh
狠	pzpzhhzpn
狡	pzpnhpnpn
狢	pzppznszh
狣	pzppnhzpn
狤	pzphshszh
狥	pzppzszhh
狦	pzpszhhss
狧	pzpphsszh
狨	pzphhpzpn
狩	pzpnnzhsn
狪	pzpszhszh
狫	pzphshppz
独	pzpszhshn
狭	pzphnphpn
狮	pzpsphszs
狯	pzppnhhzn
狰	pzppzzhhs
狱	pzpnzhpnn
狲	pzpzshspn
狳	pzppnhhspn
狴	pzphzpzhsh
狵	pzphpzpppn
狶	pzppnhpszs
狷	pzpszhszhh
狸	pzpszhhshh
狹	pzphpnpnpn
狺	pzpnhhhszh
狻	pzpznpnpzn
狼	pzpnzhhzpn
狽	pzpszhhhpn
狾	pzphshpphs
狿	pzppshzzn
猀	pzpnnhspnp
猁	pzpphspnss
猂	pzpszhhhhs
猃	pzppnhnnph
猄	pzpnhszhspn
猅	pzpshhhshhh
猆	shhhshhhhpnn
猇	pzpshzphzpz
猈	pzppszhhphs
猉	pzphsshhhpn
猊	pzppshzhhpz
猋	hpnnhpnnhpnn
猌	hpnpnspnhpnn
猍	pzphpnpnspn
猎	pzphsshszhh
猏	pzpnzhpszhh
猐	pzpnphhhpz
猑	pzpszhhhzpz
猒	szhhszhhhpnn
猓	pzpszhhhspn
猔	pzpnnzhhspn
猕	pzpzhzpzspn
猖	pzpszhhszhh
猗	pzphpnhszhs
猘	pzpphhszsss
猙	pzppnnpzhhs
猚	pzppsnhhhsh
猛	pzpzshszssh
猜	pzphhshszhh
猝	pzpnhpnpnhs
猞	pzppnhhsszh
猟	pzpnnppzhhs
猠	pzpszhsshpn
猡	pzpszsshpzn
猢	pzphsszhpzhh
猣	pzppnzspnpzn
猤	pzpznppnhhpn
猥	pzpszhshhzpn
猦	pzppzpszhshn
猧	pzpszzszszh
猨	pzppnnphhpzn
猩	pzpszhhphhsh
猪	pzphshpszhh
猫	pzphssszhsh
猬	pzpszhshszhh
猭	pzpzzhpzpppn
献	hssznphhshpnn
猯	pzpszshpszss
猰	pzphhhszphpn
猱	pzpznzsphspn
猲	pzpszhhpzpnz
猳	pzpzhshhzhzn
猴	pzppszhphhpn
猵	pzpnzhpszhss
猶	pzpnphszpzhh
猷	nphszpzhhhpnn
猸	pzpzshpszhhh
猹	pzphspnszhhh
猺	pzppnnpphhszs
猻	pzpzshpzznspn
猼	pzphszhhsnhsn
猽	pzpnzszhhnhpn
猾	pzpszznzszhh
猿	pzphshszhpzpn
獀	pzppshzhhszn
獁	pzphshhsznnnn
獂	pzphppszhhspn
獃	szshszhnphhpnn
獄	pzpnhhhszhhpnn
獅	pzppszhzhhszs
獆	pzppszhhhpnhs
獇	pzpnphhhpzzn
獈	pzpnphpnszssh
獉	pzphhhpnphspn
獊	pzppnnzhhpszh
獋	pzppszhhhnhpnhs
獌	pzpszhhszsshzn
獍	pzpnhnphszhhpz
獎	zshppznnhsnhpnn
獏	pzphssszhhhpn
獐	pzpnhnphszhhhs
獑	pzphszhhhspphs
獒	hhshzpphpnhpnn
獓	pzphhshzpphpn
獔	pzppszhhnhpnhs
獕	pzpszspsnhhhsh
獖	pzphshssszhhhpn
獗	pzphpnphzsppzpn
獘	npszspnphpnhpnn
獙	pzpnpszspnphpn
獚	pzphsshszhshpn
獛	pzpssnphnphhhpn
獜	pzpnphspnpznhzs
獝	pzpznzspszpnszh
獞	pzpnhnphszhhshh
獟	pzphshhshhshhpz
獠	pzphpnnpszhhspn
獡	pzppshzhhznnnn
獢	pzpphpnszhszszh
獣	nnpszhshhszhhpnn
獤	pzpnhszhzshphpn
獥	pzppszhhnhzpphpn
獦	pzphssszhhpzpnz
獧	pzpszsshhszhpzpn
獨	pzpszsshpzszhshn
獩	pzpshshhphsppzpn
獪	pzppnhszsnphszhh
獫	pzppnhszhszhpnpn
獬	pzppzpzhhszpphhs
獭	pzphszhspnpzszpn
獮	pzphpnszspnpnpnpn
獯	pzpphsznphshhnnnn
獰	pzpnnznznnszsshhs
獱	pzpnnzhsppszhhhpn
獲	pzphsspsnhhhshzn
獳	pzphnzsnnnnhpszss
獴	pzphssnzhhpzpppn
獵	pzpzzzszpnhznnznnz
獶	pzphpszhhnznznnpzn
獷	pzpnhphsshszhshpn
獸	szhszhszhshhszhhpnn
獹	pzpshzphzszhshszssh
獺	pzphszhspnpzszhhhpn
獻	shzphzhszhsznphshpnn
獼	pzpzhzhpnszspnpnpnpn
獽	pzpnhszhszhhhsshpzpn
獾	pzphssszhszhpsnhhhsh
獿	pzphpszhhhshshzhzpnpzn
玀	pzpszsshzznnnnpsnhhhsh
玁	pzpszhszhhpzhsshhhphpn
玂	pzphssszhszhszhhhspphs
玃	pzpszhhhszhhhpsnhhhshzn
玄	nhzzn
玅	nhzznspnp
玆	nhzznnhzzn
率	nhzznnhpnhs
玈	nhzznphpzpn
玉	hhshn
玊	hhshn
王	hhsh
玌	hhshz
玍	phhsh
玎	hhshhs
玏	hhshzp
玐	hhshpn
玑	hhshpz
玒	hhshhsh
玓	hhshpzn
玔	hhshpss
玕	hhshhhs
玖	hhshpzn
玗	hhshhhs
玘	hhshzhz
玙	hhshhzh
玚	hhshzpp
玛	hhshzzh
玜	hhshpnzn
玝	hhshphhs
玞	hhshhhpn
玟	hhshnhpn
玠	hhshpnps
玡	hhshhzsp
玢	hhshpnzp
玣	hhshnhsn
玤	hhshhhhs
玥	hhshpzhh
玦	hhshzhpn
玧	hhshznpz
玨	hhshhhsh
玩	hhshhhpz
玪	hhshpnnz
玫	hhshphpn
玬	hhshpznh
玭	hhshhzpz
玮	hhshhhzs
环	hhshhpsn
现	hhshszpz
玱	hhshpnzz
玲	hhshpnnzn
玳	hhshpshzn
玴	hhshhsshz
玵	hhshhsshh
玶	hhshhnphs
玷	hhshshszh
玸	hhshpzzhz
玹	hhshnhzzn
玺	pzspnhhshn
玻	hhshzpszn
玼	hhshshshpz
玽	hhshpzszh
玾	hhshszhhs
玿	hhshzpszh
珀	hhshpszhh
珁	hhshhzzn
珂	hhshhszhs
珃	hhshszshh
珄	hhshphhsh
珅	hhshszhhs
珆	hhshznszh
珇	hhshszhhh
珈	hhshzpszh
珉	hhshzhzhz
珊	hhshpzpzh
珋	hhshpzpzs
珌	hhshnznpn
珍	hhshpnppp
珎	hhshpzspn
珏	hhshhhshn
珐	hhshhshzn
珑	hhshhpzpn
珒	hhshzhhhhs
珓	hhshnhpnpn
珔	hhshhpszsh
珕	hhshzpzpzp
珖	hhshsnphpz
珗	hhshphshpz
珘	hhshppznhn
珙	hhshhsshpn
珚	hhshszhpnh
珛	hhshhpszhh
珜	hhshnphhhs
珝	hhshznhznh
珞	hhshpznszh
珟	hhshpzhpzn
珠	hhshphhspn
珡	hhshhhshpn
珢	hhshzhhzpn
珣	hhshpzszhh
珤	hhshphhszs
珥	hhshhsshhh
珦	hhshpszszh
珧	hhshpnhzpn
珨	hhshpnhszh
珩	hhshppshhs
珪	hhshhshhsh
珫	hhshnhznpz
珬	hhshhphzpn
班	hhshnphhsh
珮	hhshpzhszs
珯	hhshhshppz
珰	hhshsnpzhh
珱	hhshnnpzph
珲	hhshnzhzhs
珳	hhshnhpnppp
珴	hhshphshzpn
珵	hhshszhhhsh
珶	hhshnpzhzsp
珷	hhshhhshshzn
珸	hhshhszhszh
珹	hhshhpzzpn
珺	hhshzhhpszh
珻	hhshphzznhn
珼	hhshszhhhpn
珽	hhshphshzn
現	hhshszhhhpz
珿	hhshszhshpn
琀	hhshpnnzszh
琁	hhshphzshpn
琂	hhshnhhhszh
球	hhshhsnhpnn
琄	hhshszhszhh
琅	hhshnzhhzpn
理	hhshszhhshh
琇	hhshphspnzp
琈	hhshpnnpzsh
琉	hhshnhznpsz
琊	hhshhzspzs
琋	hhshpnhpszs
琌	hhshszspnnz
琍	hhshphspnss
琎	hhshhhpsnzn
琏	hhshhzhsnzn
琐	hhshsnpszpn
琑	hhshsnpszhh
琒	hhshpznhhhs
琓	hhshnnzhhpz
琔	hhshnnzhshpn
琕	hhshpszhhphs
琖	hhshhzpnhzpn
琗	hhshnhpnpnhs
琘	hhshpzhzszhh
琙	hhshhszhhzpn
琚	hhshzhphsszh
琛	hhshnzpnhspn
琜	hhshhpnpnspn
琝	hhshszhhnhpn
琞	szhhpzhhhhshn
琟	hhshpsnhhhsh
琠	hhshszhsshpn
琡	hhshshhspnzn
琢	hhshhpzppnpn
琣	hhshnhnphszh
琤	hhshpzzhhs
琥	hhshshzphzpz
琦	hhshhpnhszhs
琧	hshzzhshhhshn
琨	hhshszhhhzpz
琩	hhshszhhszhh
琪	hhshhsshhhpn
琫	hhshhhhpnhhs
琬	hhshnnzpznzz
琭	hhshzhhsnhpn
琮	hhshnnzhhspn
琯	hhshnnzszhzh
琰	hhshnppnnppn
琱	hhshpzhshszh
琲	hhshshhhshhh
琳	hhshhspnhspn
琴	hhshhhshpnnz
琵	hhshhhshhzpz
琶	hhshhhshzshz
琷	hhshnphhhpz
琸	hhshshszhhhs
琹	hhshhhshhspn
琺	hhshnnhhshzn
琻	hhshpnhhsnph
琼	hhshnhszhspn
琽	hhshhshpszhh
琾	hhshszhshpnps
琿	hhshnzhszhhhs
瑀	hhshpszhszshn
瑁	hhshszhhszhhh
瑂	hhshzshpszhhh
瑃	hhshhhhpnszhh
瑄	hhshnnzhszhhh
瑅	hhshszhhhshpn
瑆	hhshszhhphhsh
瑇	hhshhhshzznhn
瑈	hhshznzsphspn
瑉	hhshzhzhzszhh
瑊	hhshhphszhzpn
瑋	hhshzshszhhzs
瑌	hhshhpszsshpn
瑍	hhshpzszpnhpn
瑎	hhshhzpzpszhh
瑏	hhshnnzpnhzsp
瑐	hhshnphszhhss
瑑	hhshzzhpzpppn
瑒	hhshszhhhpzpp
瑓	hhshhsznphspn
瑔	hhshpszhhszpn
瑕	hhshzhshhzhzn
瑖	hhshpshhhpzzn
瑗	hhshpnnphhpzn
瑘	hhshhsshhhzs
瑙	hhshzzzpszpnh
瑚	hhshhsszhpzhh
瑛	hhshhssszhpn
瑜	hhshpnhszhhss
瑝	hhshpszhhhhsh
瑞	hhshszshpszss
瑟	hhshhhshnznpn
瑠	hhshpznzpszhsh
瑡	hhshpszhzhhszs
瑢	hhshnnzpnpnszh
瑣	hhshsnpszhhhpn
瑤	hhshpznnphhszs
瑥	hhshszhhszssh
瑦	hhshpszhhznnnn
瑧	hhshhhhpnphspn
瑨	hhshhssnphszhh
瑩	nppnnppnnzhhshn
瑪	hhshhshhsznnnn
瑫	hhshpnnppshzhh
瑬	nnhnhznpszhhshn
瑭	hhshnhpzhhsszh
瑮	hhshhszsshhspn
瑯	hhshnzhhznzs
瑰	hhshpszhhpzzn
瑱	hhshhsszhhhhpn
瑲	hhshpnnzhhpszh
瑳	hhshnphhhphsh
瑴	hshnzhhhshpzzn
瑵	hhshznnszhshn
瑶	hhshpnnpphhszs
瑷	hhshpnnpnzhpzn
瑸	hhshnnzpshshpn
瑹	hhshhsspnhhspn
瑺	hhshsnpnzszhszs
瑻	hhshzzshszhhhpn
瑼	hhshhszhhshnhsn
瑽	hhshppspnpnshpn
瑾	hhshhsshszhhhsh
瑿	hphhpnzpzznhhshn
璀	hhshszspsnhhhsh
璁	hhshpszpznhnznn
璂	hhshhsshhhpnhsh
璃	hhshnhpnzsszzn
璄	hhshnhnphszhhpz
璅	hhshzzzszhhhspn
璆	hhshznhznhpnppp
璇	hhshnhzpphzshpn
璈	hhshhhshzpphpn
璉	hhshhszhhhsnzn
璊	hhshhsshszspnpn
璋	hhshnhnphszhhhs
璌	hhshnnzhszhshpn
璍	hhshhsshhsshhs
璎	hhshszpnszpnzph
璏	hhshzzhphhpnhzpz
璐	hhshszhshshpznszh
璑	hhshphhsssshnnnn
璒	hhshznppnhszhnph
璓	hhshhssphspnzp
璔	hhshnpszsnphszhh
璕	hhshzhhhshszhhsn
璖	hhshnnhhzhzhspn
璗	nnhszhhhpzpphhshn
璘	hhshnphspnpznhzs
璙	hhshhpnnpszhhspn
璚	hhshznzspszpnszh
璛	hhshzhhspshhzzshs
璜	hhshhsshszhshpn
璝	hhshszhshszhhhpn
璞	hhshssnphnphhhpn
璟	hhshszhhnhszhspn
璠	hhshpnphspnszhsh
璡	hhshpsnhhhshnzn
璢	hhshhsshzzhszhsh
璣	hhshzznzznhpnzpn
璤	hhshhszhhshnnznn
璥	hhshhsspzszhphpn
璦	hhshpnnpnznznnpzn
璧	zhpszhnhnphhshhshn
璨	hhshshpznznnphspn
璩	hhshshzphzhpzpppn
璪	hhshszhszhszhhspn
璫	hhshsnpnzszhszhsh
璬	hhshpszhhnhzpphpn
璭	hhshnzhszhhhsnzn
璮	hhshnhszszhhszhhh
璯	hhshpnhszsnphszhh
環	hhshszsshhszhpzpn
璱	hhshhhshhhshnznpn
璲	hhshnphpzpppnnzn
璳	hhshphhspnszhhhpn
璴	hhshhspnhspnzshpn
璵	hhshpshhhzszhhhpn
璶	hhshzhhshnnnnszssh
璷	hhshhszhhsnnhzpphpn
璸	hhshnnzhsppszhhhpn
璹	hhshhshzhshhszhhsn
璺	pshhszhszhzhhnzhhshn
璻	hhshznhznhnhpnpnhs
璼	hhshhszhszphnszssh
璽	hpnszspnpnpnpnhhshn
璾	hhshnhnpszppznpshh
璿	hhshshnzhpnpnszhhh
瓀	hhshhnzsnnnnhpszss
瓁	hhshhsspsnhhhshzn
瓂	hhshhsshshznszssh
瓃	hhshszhshszhshszhsh
瓄	hhshhshszsshszhhhpn
瓅	hhshpszhhzznzznhspn
瓆	hhshpphspphsszhhhpn
瓇	hhshhpszhhnznznnpzn
瓈	hhshphspnpzppnsnhpn
瓉	hhshhhpnhhpnszhhhpn
瓊	hhshpzszpnszhhhpzn
瓋	hhshnhnpszhsszhnzn
瓌	hhshnhszsshsnhpnpzpn
瓍	hhshzshphshszhhnzn
瓎	hhshhszhspnpzszhhhpn
瓏	hhshnhnphszhhshzhzhhh
瓐	hhshshzphzszhshszssh
瓑	hhshhpphspnphspnshsh
瓒	hhshphshpzphshpzszpn
瓓	hhshszhhszhhhsznphspn
瓔	hhshszhhhpnszhhhpnzph
瓕	zhzhpnszspnpnpnpnhhshn
瓖	hhshnhszhszhhhsshpzpn
瓗	hhshszspsnhhhshszpnszh
瓘	hhshhssszhszhpsnhhhsh
瓙	hhshhshzhshhszhhsnnnnn
瓚	hhshphshpzphshpzszhhhpn
瓛	hhshshzphzhszhsznphshpnn
瓜	ppznn
瓝	ppznnpzn
瓠	hpnhhzppznn
瓡	hshnphhsppznn
瓢	hszsshhhspnppznn
瓣	nhnphhpppznnnhnphhs
瓤	nhszhszhhhsshpzpnppznn
瓦	hzzn
瓧	hzznhs
瓨	hshhzzn
瓩	hzznphs
瓪	hzznppzn
瓫	pnzphzzn
瓬	nhzphzzn
瓭	nzpzhzzn
瓮	pnznhzzn
瓯	hpnzhzzn
瓰	hzznpnzp
瓱	hzznphhz
瓲	hzznhzsz
瓳	hsszhhzzn
瓴	pnnznhzzn
瓵	znszhhzzn
瓶	nphhpshzzn
瓷	nhpzpnhzzn
瓸	hzznhpszhh
瓹	szhszhhhzzn
瓺	hshhhznhzzn
瓻	pnhpszshzzn
瓼	hzznszhhshh
瓽	snpnzszhhzzn
瓾	phspnzphhzzn
瓿	nhnphszhhzzn
甀	phshsshhhzzn
甁	phhpphhshzzn
甂	nzhpszhsshzzn
甃	phspnnppnhzzn
甄	hszsshhshhzzn
甅	hzznhpszhhshh
甆	nphzznzznhzzn
甇	nppnnppnnzhzzn
甈	pszhhhhspnhzzn
甉	nphzhhsspnhzzn
甊	szhhszhszphhzzn
甋	nhnpszhsszhhzzn
甌	hszhszhszhzhzzn
甍	hssszsshnzhzzn
甎	hszhhshnhsnhzzn
甏	hshszhnphppphzzn
甐	nphspnpznhzshzzn
甑	npszsnphszhhhzzn
甒	phhsssshnnnnhzzn
甓	zhpszhnhnphhshzzn
甔	pzhppnnhhhszhhzzn
甕	nhzzppsnhhhshhzzn
甖	szhhhpnszhhhpnhzzn
甗	shzphzhszhsznphshzzn
甘	hsshh
甙	hhsshhzn
甚	hsshhhpnz
甛	hsshhphsszh
甜	phsszhhsshh
甝	shzphzpzhsshh
甞	snpnzszhhsshh
生	phhsh
甠	szhhphhsh
甡	phhshphhsh
產	nhpnhpphhsh
産	nhnphpphhsh
甤	hpzpppnphhsh
甥	phhshszhshzp
甦	hszhhpnphhsh
甧	phhshphhshszhh
用	pzhhs
甩	pzhhz
甫	hszhhsn
甬	znszhhs
甭	hpsnpzhhs
甮	pzpppzhhs
甯	nnznznnszhhs
田	szhsh
由	szhsh
甲	szhhs
申	szhhs
电	szhhz
甶	pszhsh
男	szhshzp
甸	pzszhsh
甹	szhshhz
町	szhshhs
画	hszhshzs
甼	szhshhs
甽	szhshpss
甾	zzzszhsh
甿	szhshnhz
畀	szhshhps
畁	szhshhps
畂	szhshpzn
畃	szhhspzn
畄	nnpszhsh
畅	szhhszpp
畆	nhszhshzn
畇	szhshpznh
畈	szhshppzn
畉	szhshhhpn
畊	szhshhhps
畋	szhshphpn
界	szhshpnps
畍	szhshpnps
畎	szhshhpnn
畏	szhshhzpn
畐	hszhszhsh
畑	nppnszhsh
畒	nhszhshpn
畓	szpnszhsh
畔	szhshnphhs
畕	szhshszhsh
畖	szhshppznn
畗	nhszhszhsh
畘	szhshszshh
留	pznzpszhsh
畚	znhpnszhsh
畛	szhshpnppp
畜	nhzznszhsh
畝	nhszhshpzn
畞	hsszhshpzn
畟	szhshpnpzn
畠	pszhhszhsh
畡	szhshnhzppn
畢	szhhhsshhs
畣	pnhszhszhsh
畤	szhshhshhsn
略	szhshpznszh
畦	szhshhshhsh
畧	szhshpznszh
畨	nphspnszhsh
畩	szhshnhpzpn
番	pnphspnszhsh
畫	zhhhshszhshh
畬	pnhhspnszhsh
畭	szhshpnhhspn
畮	szhshphzznhn
畯	szhshznpnpzn
異	szhshhsshpn
畱	hsshzzhszhsh
畲	pnhhspnszhsh
畳	szhshnzszhhh
畴	szhshhhhphsn
畵	zhhhshszhshzn
當	snpnzszhszhsh
畷	szhshznznznzn
畸	szhshhpnhszhs
畹	szhshnnzpznzz
畺	hszhshhszhshh
畻	szhshnphhpnhsh
畼	szhshszhhhpzpp
畽	szhshphszhhshh
畾	szhshszhshszhsh
畿	zznzznhszhshzpn
疀	zzzszhshhzhhshpn
疁	szhshznhznhpnppp
疂	szhshnhpnnzszhhh
疃	szhshnhnphszhhshh
疄	szhshnphspnpznhzs
疅	szhshhszhshhszhshh
疆	zhzhshhszhshhszhshh
疇	szhshhshzhshhszhhsn
疈	hszhszhshnphszhszhsh
疉	szhshszhshszhshnzzzh
疊	szhshszhshszhshnzszhhh
疌	hzhhshpn
疍	zshpnszhhh
疎	zshshhszhspn
疏	zshshnhznpsz
疐	hsnzszhshzshpn
疑	pzphhpnznzshpn
疓	nhpnhzp
疔	nhpnhhs
疕	nhpnhpz
疖	nhpnhzs
疗	nhpnhzs
疘	nhpnhhsh
疙	nhpnhphz
疚	nhpnhpzn
疛	nhpnhhsn
疜	nhpnhhsn
疝	nhpnhszs
疞	nhpnhhhz
疟	nhpnhhzh
疠	nhpnhhzp
疡	nhpnhzpp
疢	nhpnhnppn
疣	nhpnhhpzn
疤	nhpnhzshz
疥	nhpnhpnps
疦	nhpnhzhpn
疧	nhpnhpzhz
疨	nhpnhhzsp
疩	nhpnhpzhs
疪	nhpnhhzpz
疫	nhpnhpzzn
疬	nhpnhhpzp
疭	nhpnhpnpn
疮	nhpnhpnzz
疯	nhpnhpzpn
疰	nhpnhnhhsh
疱	nhpnhpzzhz
疲	nhpnhzpszn
疳	nhpnhhsshh
疴	nhpnhhszhs
疵	nhpnhshshpz
疶	nhpnhhsshz
疷	nhpnhpzhzn
疸	nhpnhszhhh
疹	nhpnhpnppp
疺	nhpnhpnzn
疻	nhpnhszhpn
疼	nhpnhpznnn
疽	nhpnhszhhh
疾	nhpnhphhpn
疿	nhpnhzhzps
痀	nhpnhpzszh
痁	nhpnhshszh
痂	nhpnhzpszh
痃	nhpnhnhzzn
痄	nhpnhphshh
病	nhpnhhszpn
痆	nhpnhzhppz
症	nhpnhhshsh
痈	nhpnhpzhhs
痉	nhpnhznhsh
痊	nhpnhpnhhsh
痋	nhpnhszhshn
痌	nhpnhszhszh
痍	nhpnhhzhzpn
痎	nhpnhnhzppn
痏	nhpnhhpszhh
痐	nhpnhszszhh
痑	nhpnhpznpzn
痒	nhpnhnphhhs
痓	nhpnhhznhsh
痔	nhpnhhshhsn
痕	nhpnhzhhzpn
痖	nhpnhhssnph
痗	nhpnhphzznhn
痘	nhpnhhszhnph
痙	nhpnhhzzzhsh
痚	nhpnhhshpzsh
痛	nhpnhznszhhs
痜	nhpnhphspnpz
痝	nhpnhhpzpppn
痞	nhpnhhpsnszh
痟	nhpnhsnpszhh
痠	nhpnhznpnpzn
痡	nhpnhhszhhsn
痢	nhpnhphspnss
痣	nhpnhhshnznn
痤	nhpnhpnpnhsh
痥	nhpnhnpszhpz
痦	nhpnhhszhszh
痧	nhpnhnnhspnp
痨	nhpnhhssnzzp
痩	nhpnhszhhszn
痪	nhpnhpzszhpn
痫	nhpnhnszhspn
痬	nhpnhszhhpzpp
痭	nhpnhpzhhpzhh
痮	nhpnhhshhhzpn
痯	nhpnhnnzszhzh
痰	nhpnhnppnnppn
痱	nhpnhshhhshhh
痲	nhpnhhspshspz
痳	nhpnhhspnhspn
痴	nhpnhphhpnszh
痵	nhpnhphspnzsh
痶	nhpnhszhsshpn
痷	nhpnhhpnszhhz
痸	nhpnhphhszsss
痹	nhpnhszhshhps
痺	nhpnhpszhhphs
痻	nhpnhpzhzszhh
痼	nhpnhszhsszhh
痽	nhpnhpsnhhhsh
痾	nhpnhzshszhs
痿	nhpnhphspnzph
瘀	nhpnhnhzppnnn
瘁	nhpnhnhpnpnhs
瘂	nhpnhhshzzhsh
瘃	nhpnhhpzppnpn
瘄	nhpnhhsshszhh
瘅	nhpnhnpszhhhs
瘆	nhpnhznhpnppp
瘇	nhpnhphszhhshh
瘈	nhpnhhhhszphpn
瘉	nhpnhpnhszhhss
瘊	nhpnhpszhphhpn
瘋	nhpnhpzpszhshn
瘌	nhpnhhszhspnss
瘍	nhpnhszhhhpzpp
瘎	nhpnhhsshhhpnz
瘏	nhpnhhshpszhh
瘐	nhpnhpshzhhpn
瘑	nhpnhszzszszh
瘒	nhpnhnzhszhhhs
瘓	nhpnhpzszpnhpn
瘔	nhpnhhsshsszh
瘕	nhpnhzhshhzhzn
瘖	nhpnhnhnphszhh
瘗	nhpnhhnphpnhsh
瘘	nhpnhnphspnzph
瘙	nhpnhznnszhshn
瘚	nhpnhnphzsppzpn
瘛	nhpnhhhhszpnznn
瘜	nhpnhpszhhhnznn
瘝	nhpnhszsshsppnn
瘞	nhpnhhpnpnpnhsh
瘟	nhpnhszhhszssh
瘠	nhpnhnhpnpnszhh
瘡	nhpnhpnnzhhpszh
瘢	nhpnhppznhnpzzn
瘣	nhpnhpszhhpzzn
瘤	nhpnhpznzpszhsh
瘥	nhpnhnphhhphsh
瘦	nhpnhpshzhhszn
瘧	nhpnhshzphzhzh
瘨	nhpnhhsszhhhhpn
瘩	nhpnhhsspnhszh
瘪	nhpnhpszhhhpnpz
瘫	nhpnhznpsnhhhsh
瘬	nhpnhzhzhshhhzpn
瘭	nhpnhhszsshhhspn
瘮	nhpnhznznznpnppp
瘯	nhpnhnhzpphphhpn
瘰	nhpnhszhshzznspn
瘱	nhpnhhpnpnpnnznn
瘲	nhpnhppspnpnshpn
瘳	nhpnhznhznhpnppp
瘴	nhpnhnhnphszhhhs
瘵	nhpnhpznnznhhspn
瘶	nhpnhhszhspnpzpn
瘷	nhpnhhszhspnphpn
瘸	nhpnhzpszhszpnpn
瘹	nhpnhpnhhsnphpzn
瘺	nhpnhzhphszsnnnn
瘻	nhpnhszhhszhszph
瘼	nhpnhhssszhhhpn
瘽	nhpnhhsshszhhhsh
瘾	nhpnhzspzzhhnznn
瘿	nhpnhszpnszpnzph
癀	nhpnhhsshszhshpn
癁	nhpnhppsphszhhpzn
療	nhpnhhpnnpszhhspn
癃	nhpnhzspznhphhsh
癄	nhpnhpsnhhhshnnnn
癅	nhpnhhsshzzhszhsh
癆	nhpnhnppnnppnnzzp
癇	nhpnhszhhszhhpzhh
癈	nhpnhznppnzhzpzzn
癉	nhpnhszhszhszhhhs
癊	nhpnhzspnnzhhzn
癋	nhpnhhshzzhshnznn
癌	nhpnhszhszhszhszs
癍	nhpnhhhshnhpnhhsh
癎	nhpnhszhhszhhszhh
癏	nhpnhszsshhszhpzpn
癐	nhpnhpnhszsnphszhh
癑	nhpnhszhsshhphhzpn
癒	nhpnhpnhszhhssnznn
癓	nhpnhppsszshpzphpn
癔	nhpnhnhnphszhhnznn
癕	nhpnhnhzzppsnhhhsh
癖	nhpnhzhpszhnhnphhs
癗	nhpnhhnzsnnnnszhsh
癘	nhpnhhssszhhszshn
癙	nhpnhpshzhhznnznnz
癚	nhpnhpzhppnnhhhszh
癛	nhpnhnhszszhhphspn
癜	nhpnhzhphsshpnpzzn
癝	nhpnhnhszszhhhhspn
癞	nhpnhhszhspnpzszpn
癟	nhpnhpszhhhpnhszhss
癠	nhpnhnhnpszppznphhs
癡	nhpnhpzphhpnznzshpn
癢	nhpnhnphhhpnnzhhzpn
癣	nhpnhpzszhshhnphhhs
癤	nhpnhphnphnzhhznzs
癥	nhpnhppsszshhhshphpn
癦	nhpnhsznphshhnnnnhsh
癧	nhpnhhpphspnphspnshsh
癨	nhpnhhnzsnnnnpsnhhhsh
癩	nhpnhhszhspnpzszhhhpn
癪	nhpnhphspnhhshszhhhpn
癫	nhpnhhsszhhhhpnhpszpn
癬	nhpnhpzszhshnnnnnphhhs
癭	nhpnhszhhhpnszhhhpnzph
癮	nhpnhzspnnphshzhhnznn
癯	nhpnhszhhhszhhhpsnhhhsh
癰	nhpnhzzzszhzshzpsnhhhsh
癱	nhpnhhsshszhhhpnpsnhhhsh
癲	nhpnhhsszhhhhpnhpszhhhpn
癳	nhpnhszhshszhshszhshzznspn
癴	nhpnhnhhhszhzznnnnzznnnnphhs
癵	nhpnhnhhhszhzznnnnzznnnnszpnpn
癷	znppnhhs
癸	znppnhhpn
癹	znppnpzzn
発	znppnhhpz
登	znppnhszhnph
發	znppnzhzpzzn
白	pszhh
百	hpszhh
癿	pszhhz
皀	pszhhpz
皁	pszhhhs
皂	pszhhhz
皃	pszhhpz
的	pszhhpzn
皅	pszhhzshz
皆	hzpzpszhh
皇	pszhhhhsh
皈	pszhhppzn
皉	pszhhshshpz
皊	pszhhpnnzn
皋	pszhhhpnhs
皌	pszhhhhspn
皍	pszhhhzzs
皎	pszhhnhpnpn
皏	pszhhnphhps
皐	pszhhnhpnhs
皑	pszhhszszhz
皒	pszhhphshzpn
皓	pszhhphshszh
皔	pszhhszhhhhs
皕	hpszhhhpszhh
皖	pszhhnnzhhpz
皗	pszhhpzhshszh
皘	pszhhhhshszhh
皙	hspnpphspszhh
皚	pszhhszshszhnph
皛	pszhhpszhhpszhh
皜	pszhhnhszhszszh
皝	pszhhhhshsnphpz
皞	pszhhpszhhhpnhs
皟	pszhhhhshszhhhpn
皠	pszhhszspsnhhhsh
皡	pszhhpszhhnhpnhs
皢	pszhhhshhshhshhpz
皣	pszhhhsshhsshhs
皤	pszhhpnphspnszhsh
皥	pszhhpszhhhnhpnhs
皦	pszhhpszhhnhzpphpn
皧	pszhhpnnpnznznnpzn
皨	pszhhpszhhpszhhhsh
皩	pszhhhhshszhhsnphpz
皪	pszhhpszhhzznzznhspn
皫	pszhhnhpzsshhzpznnnn
皬	pszhhhnzsnnnnpsnhhhsh
皭	pszhhpnnpszsshzhhznhsn
皮	zpszn
皯	zpsznhhs
皰	zpsznpzzhz
皱	pzzhhzpszn
皲	nzhzshzpszn
皳	hsnhpnnzpszn
皴	znpnpznzpszn
皵	hsshszhhzpszn
皶	hspnszhhhzpszn
皷	hshszhnphzpszn
皸	nzhszhhhszpszn
皹	zpsznnzhszhhhs
皺	pzzsppzzspzpszn
皻	shzphzszhhhzpszn
皼	hshnzhszhnphzpszn
皽	nhszszhhszhhhzpszn
皾	hshszsshszhhhpnzpszn
皿	szssh
盀	snszssh
盁	zpszssh
盂	hhsszssh
盃	hpsnszssh
盄	zhzsszssh
盅	szhsszssh
盆	pnzpszssh
盇	hpnnszssh
盈	zpznszssh
盉	phspnszssh
益	nphpnszssh
盋	hpznnszssh
盌	pznzzszssh
盍	hshznszssh
盎	szhpnszssh
盏	hhzpnszssh
盐	hshsnszssh
监	ssphnszssh
盒	pnhszhszssh
盓	nnhhhsszssh
盔	hpnppnszssh
盕	nnhpznszssh
盖	nphhshszssh
盗	nhpzpnszssh
盘	ppznhnszssh
盙	hszhhsnszssh
盚	hsnhpnnszssh
盛	hpzzpnszssh
盜	nnhpzpnszssh
盝	zhhsnhpnszssh
盞	hzpnhzpnszssh
盟	szhhpzhhszssh
盠	zzhpzpppnszssh
盡	zhhshnnnnszssh
盢	szhshhpnnszssh
監	hszhszphnszssh
盤	ppznhnpzznszssh
盥	pshhszpnzhhszssh
盦	pnnzhszpzhhszssh
盧	shzphzszhshszssh
盨	ppphpszhhhpnszssh
盩	hshnphhsphpnszssh
盪	nnhszhhhpzppszssh
盫	pnhszhhszpzhhszssh
盬	hszhszphhsszhszssh
盭	zznhshnphhsphpnszssh
目	szhhh
盯	szhhhhs
盰	szhhhhhs
盱	szhhhhhs
盲	nhzszhhh
盳	szhhhnhz
直	hsszhhhh
盵	szhhhphz
盶	szhhhhhpz
盷	szhhhpznh
相	hspnszhhh
盹	szhhhhzsz
盺	szhhhpphs
盻	szhhhpnhz
盼	szhhhpnzp
盽	szhhhhhhs
盾	pphsszhhh
盿	szhhhnhpn
眀	szhhhpzhh
省	spnpszhhh
眂	szhhhpzhz
眃	szhhhhhzn
眄	szhhhhszz
眅	szhhhppzn
眆	szhhhnhzp
眇	szhhhspnp
眈	szhhhnzpz
眉	zshpszhhh
眊	szhhhphhz
看	phhpszhhh
県	szhhhzspn
眍	szhhhhpnz
眎	szhhhhhspn
眏	szhhhszhpn
眐	szhhhhshsh
眑	szhhhzznzp
眒	szhhhszhhs
眓	szhhhhzzpn
眔	szsshsppnn
眕	szhhhpnppp
眖	szhhhszhpz
眗	szhhhpzszh
眘	hpnnpszhhh
眙	szhhhznszh
眚	phhshszhhh
眛	szhhhhhspn
眜	szhhhhhspn
眝	szhhhnnzhs
眞	pzszhhhzpn
真	hsszhhhhpn
眠	szhhhzhzhz
眡	szhhhpzhzn
眢	pznzzszhhh
眣	szhhhphhpn
眤	szhhhzhppz
眥	shshpzszhhh
眦	szhhhshshpz
眧	szhhhzpszh
眨	szhhhpnzn
眩	szhhhnhzzn
眪	szhhhhszpn
眫	szhhhnphhs
眬	szhhhhpzpn
眭	szhhhhshhsh
眮	szhhhszhszh
眯	szhhhnphspn
眰	szhhhhznhsh
眱	szhhhhzhzpn
眲	szhhhhsshhh
眳	szhhhpznszh
眴	szhhhpzszhh
眵	szhhhpznpzn
眶	szhhhhhhshz
眷	nphhpnszhhh
眸	szhhhznphhs
眹	szhhhnphhpn
眺	szhhhpnhzpn
眻	szhhhnphhhs
眼	szhhhzhhzpn
眽	szhhhpppzpn
眾	szsshpspnpn
眿	szhhhnzzpn
着	nphhhpszhhh
睁	szhhhpzzhhs
睂	pnpnshpszhhh
睃	szhhhznpnpzn
睄	szhhhsnpszhh
睅	szhhhszhhhhs
睆	szhhhnnzhhpz
睇	szhhhnpzhzsp
睈	szhhhszhhhsh
睉	szhhhpnpnhsh
睊	szhhhszhszhh
睋	szhhhphshzpn
睌	szhhhpzszhpz
睍	szhhhszhhhpz
睎	szhhhpnhpszs
睏	szhhhszhspnh
睐	szhhhhnphspn
睑	szhhhpnhnnph
睒	szhhhnppnnppn
睓	szhhhszhsshpn
睔	szhhhpnhszhss
睕	szhhhnnzpznzz
睖	szhhhhshpnpzn
睗	szhhhszhhpzpp
睘	szsshhszhpzpn
睙	szhhhnzhphpnn
睚	szhhhhphshhsh
睛	szhhhhhshszhh
睜	szhhhpnnpzhhs
睝	phspnpzpszhhh
睞	szhhhhpnpnspn
睟	szhhhnhpnpnhs
睠	szhhhnphhpnzz
睡	szhhhphshsshh
睢	szhhhpsnhhhsh
督	shhspnznszhhh
睤	szhhhszhshhps
睥	szhhhpszhhphs
睦	szhhhhshpnhsh
睧	szhhhpzhzszhh
睨	szhhhpshzhhpz
睩	szhhhzhhsnhpn
睪	szsshhshnphhs
睫	szhhhhzhhshpn
睬	szhhhpnnphspn
睭	szhhhpzhshszh
睮	szhhhpnhszhhss
睯	zhzhzphpnszhhh
睰	szhhhhsshpszh
睱	szhhhzhshhzhzn
睲	szhhhszhhphhsh
睳	szhhhhpnhshhsh
睴	szhhhnzhszhhhs
睵	szhhhhshszhzpn
睶	szhhhhhhpnszhh
睷	szhhhzhhhhszn
睸	szhhhzshpszhhh
睹	szhhhhshpszhh
睺	szhhhpszhphhpn
睻	szhhhnnzhszhhh
睼	szhhhszhhhshpn
睽	szhhhznppnhhpn
睾	pszsshhshnphhs
睿	shnzhpnpnszhhh
瞀	znzspphpnszhhh
瞁	szhhhszhhhhpnn
瞂	pphsszhhhhpznn
瞃	szhhhpphsszhhh
瞄	szhhhhssszhsh
瞅	szhhhphspnnppn
瞆	szhhhszhshszpn
瞇	szhhhnphspnnzn
瞈	szhhhpnznznhznh
瞉	hshnzhszhhhpzzn
瞊	szhhhnhpzhhsszh
瞋	szhhhhsszhhhhpn
瞌	szhhhhshznszssh
瞍	szhhhpshzhhszn
瞎	szhhhnnzhhhsszh
瞏	szsshhshszhpzpn
瞐	szhhhszhhhszhhh
瞑	szhhhnzszhhnhpn
瞒	szhhhhsshszpnpn
瞓	szhhhnhhhszhpss
瞔	szhhhhhshszhhhpn
瞕	szhhhnhnphszhhhs
瞖	hphhpnzpzznszhhh
瞗	szhhhpszhhhznnnn
瞘	szhhhhszhszhszhz
瞙	szhhhhssszhhhpn
瞚	szhhhnnzhszhshpn
瞛	szhhhppspnpnshpn
瞜	szhhhszhhszhszph
瞝	szhhhnhpnzsszzn
瞞	szhhhhsshszspnpn
瞟	szhhhhszsshhhspn
瞠	szhhhsnpnzszhhsh
瞡	szhhhhhpnszhhhpz
瞢	hssszsshnzszhhh
瞣	szhhhszhszhsnznn
瞤	szhhhszhhszhhhhsh
瞥	npszspnphpnszhhh
瞦	szhhhhshszhnphszh
瞧	szhhhpsnhhhshnnnn
瞨	szhhhssnphnphhhpn
瞩	szhhhzhppszhszshn
瞪	szhhhznppnhszhnph
瞫	szhhhhszsshszhhhs
瞬	szhhhpnnpnzpznhzs
瞭	szhhhhpnnpszhhspn
瞮	szhhhnhznszhhphpn
瞯	szhhhszhhszhhpzhh
瞰	szhhhzhsshhhphpn
瞱	szhhhhsshhsshhs
瞲	szhhhznzspszpnszh
瞳	szhhhnhnphszhhshh
瞴	szhhhphhsssshnnnn
瞵	szhhhnphspnpznhzs
瞶	szhhhszhshszhhhpn
瞷	szhhhszhhszhhszhh
瞸	szhhhhsshsshzhspn
瞹	szhhhpnnpnznznnpzn
瞺	szhhhpnhszsnphszhh
瞻	szhhhpzhppnnhhhszh
瞼	szhhhpnhszhszhpnpn
瞽	hshszhnphhsznszhhh
瞾	szhhhszhhhnnzpnhsh
瞿	szhhhszhhhpsnhhhsh
矀	szhhhppsszshpzphpn
矁	szhhhphspnnppnnznn
矂	szhhhszhszhszhhspn
矃	szhhhnnznznnszsshhs
矄	szhhhphsznphshhnnnn
矅	szhhhznhznhpsnhhhsh
矆	szhhhhsspsnhhhshzn
矇	szhhhhssnzhhpzpppn
矈	szhhhpszhhnnzpnnhzp
矉	szhhhnnzhsppszhhhpn
矊	szhhhzznnnnpszhhszs
矋	szhhhhphssszhhszshn
矌	szhhhnhphsshszhshpn
矍	szhhhszhhhpsnhhhshzn
矎	szhhhpzszpnszhhhpzn
矏	szhhhpszhhhnnzpnnhzp
矐	szhhhhnzsnnnnpsnhhhsh
矑	szhhhshzphzszhshszssh
矒	szhhhhssszsshnzszhhh
矓	szhhhnhnphszhhshzhzhhh
矔	szhhhhssszhszhpsnhhhsh
矕	nhhhszhzznnnnzznnnnszhhh
矖	szhhhhsznhsznnhpzsshhzpz
矗	hsszhhhhhsszhhhhhsszhhhh
矘	szhhhsnpnzszhsznphshhnnnn
矙	szhhhszhhszhhzhsshhhphpn
矚	szhhhzhpsnhpnszsshpzszhshn
矛	znzsp
矜	znzsppnnz
矝	znzsppnnzn
矞	znzspszpnszh
矟	znzspsnpszhh
矠	znzsphsshszhh
矡	znzspszhhhszhhhpsnhhhshzn
矢	phhpn
矣	znphhpn
矤	zhzphhpn
知	phhpnszh
矦	pzhpphhpn
矧	phhpnzhzs
矨	phhpnphpn
矩	phhpnhzhz
矪	phhpnppznhn
矫	phhpnphpnps
矬	phhpnpnpnhsh
短	phhpnhszhnph
矮	phhpnphspnzph
矯	phhpnphpnszhszszh
矰	phhpnnpszsnphszhh
矱	phhpnhsspsnhhhshzn
矲	phhpnszsshznszhhpzpz
石	hpszh
矴	hpszhhs
矵	hpszhss
矶	hpszhpz
矷	hpszhzsh
矸	hpszhhhs
矹	hpszhhpz
矺	hpszhphz
矻	hpszhphz
矼	hpszhhsh
矽	hpszhpzn
矾	hpszhpzn
矿	hpszhnhp
砀	hpszhzpp
码	hpszhzzh
砂	hpszhspnp
砃	hpszhpznh
砄	hpszhzhpn
砅	hpszhszpn
砆	hpszhhhpn
砇	hpszhnhpn
砈	hpszhhpzz
砉	hhhshpszh
砊	hpszhnhpz
砋	hpszhshsh
砌	hpszhhzzp
砍	hpszhpzpn
砎	hpszhpnps
砏	hpszhpnzp
砐	hpszhpzn
砑	hpszhhzsp
砒	hpszhhzpz
砓	hpszhpzzn
研	hpszhhhps
砕	hpszhpzhs
砖	hpszhhhzn
砗	hpszhhzhs
砘	hpszhhzsz
砙	hpszhhzzn
砚	hpszhszpz
砛	hpszhpnnz
砜	hpszhpzpn
砝	hpszhhshzn
砞	hpszhhhspn
砟	hpszhphshh
砠	hpszhszhhh
砡	hpszhhhshn
砢	hpszhhszhs
砣	hpszhnnzpz
砤	hpszhphzsz
砥	hpszhpzhzn
砦	shshpzhpszh
砧	hpszhshszh
砨	hpszhnzhpz
砩	hpszhzhzps
砪	hpszhzznhn
砫	hpszhnhhsh
砬	hpszhnhnph
砭	hpszhpnzn
砮	zphznhpszh
砯	hpszhnszpn
砰	hpszhhnphs
砱	hpszhpnnzn
砲	hpszhpzzhz
砳	hpszhhpszh
破	hpszhzpszn
砵	hpszhhspnh
砶	hpszhpszhh
砷	hpszhszhhs
砸	hpszhhszsz
砹	hpszhhsspn
砺	hpszhhphzp
砻	hpzpnhpszh
砼	hpszhpnhsh
砽	hpszhpzhhs
砾	hpszhpzspn
砿	hpszhnhpzn
础	hpszhzsszs
硁	hpszhznhsh
硂	hpszhpnhhsh
硃	hpszhphhspn
硄	hpszhsnphpz
硅	hpszhhshhsh
硆	hpszhpnhszh
硇	hpszhpszpnh
硈	hpszhhshszh
硉	hpszhzhhhhs
硊	hpszhpzhpzz
硋	hpszhnhzppn
硌	hpszhpznszh
硍	hpszhzhhzpn
硎	hpszhhhpsss
硏	hpszhhhphhs
硐	hpszhszhszh
硑	hpszhnphhps
硒	hpszhhszpzh
硓	hpszhhshppz
硔	hpszhhsshpn
硕	hpszhhpszpn
硖	hpszhhnphpn
硗	hpszhhzphpz
硘	hpszhszszhh
硙	hpszhszszhz
硚	hpszhphpnps
硛	hpszhnhpspn
硜	hpszhhzzzhsh
硝	hpszhsnpszhh
硞	hpszhphshszh
硟	hpszhpshzzn
硠	hpszhnzhhzpn
硡	hpszhnnzhpzn
硢	hpszhpnhhspn
硣	hpszhhshpzsh
硤	hpszhhpnpnpn
硥	hpszhhpzpppn
硦	hpszhhhshhps
硧	hpszhznszhhs
硨	hpszhhszhhhs
硩	hshpphshpszh
硪	hpszhphshzpn
硫	hpszhnhznpsz
硬	hpszhhszhhpn
硭	hpszhhssnhz
确	hpszhpzpzhhs
硯	hpszhszhhhpz
硰	nnhspnphpszh
硱	hpszhszhspnh
硲	hpszhpnpnszh
硳	hpszhhshpspn
硴	hpszhhsspspz
硵	hpszhshszpnh
硶	hpszhszspnnz
硷	hpszhpnhnnph
硸	hpszhszshphhs
硹	hpszhhspnpnzn
硺	hpszhhpzppnpn
硻	hszhszznhpszh
硼	hpszhpzhhpzhh
硽	hpszhhpnszhhz
硾	hpszhphshsshh
硿	hpszhnnzpnhsh
碀	hpszhpzzhhs
碁	hsshhhpnhpszh
碂	hpszhnnzhhspn
碃	hpszhhhshszhh
碄	hpszhhspnhspn
碅	hpszhszphspnh
碆	nnhzpsznhpszh
碇	hpszhnnzhshpn
碈	hpszhpzhzszhh
碉	hpszhpzhshszh
碊	hpszhhzpnhzpn
碋	hpszhszshszhs
碌	hpszhzhhsnhpn
碍	hpszhszhhhhsn
碎	hpszhnhpnpnhs
碏	hpszhhsshszhh
碐	hpszhhshpnpzn
碑	hpszhpszhhphs
碒	hpszhpnhhsnph
碓	hpszhpsnhhhsh
碔	hpszhhhshshzn
碕	hpszhhpnhszhs
碖	hpszhpnhszhss
碗	hpszhnnzpznzz
碘	hpszhszhsshpn
碙	hpszhsznphszs
碚	hpszhnhnphszh
碛	hpszhhhshszpn
碜	hpszhznhpnppp
碝	hpszhhpszsshpn
碞	szhszhszhhpszh
碟	hpszhhsshzhspn
碠	hpszhnhszhnzhs
碡	hpszhhhshzznhn
碢	hpszhszzszszh
碣	hpszhszhhpzpnz
碤	hpszhhssszhpn
碥	hpszhnzhpszhss
碦	hpszhnnzpznszh
碧	hhshpszhhhpszh
碨	hpszhszhshhzpn
碩	hpszhhpszhhhpn
碪	hpszhhsshhhpnz
碫	hpszhpshhhpzzn
碬	hpszhzhshhzhzn
碭	hpszhszhhhpzpp
碮	hpszhszhhhshpn
碯	hpszhzzzpszpnh
碰	hpszhnphssnph
碱	hpszhhphszhzpn
碲	hpszhnhnpnzszs
碳	hpszhszshpnppn
碴	hpszhhspnszhhh
碵	hpszhshszhhhpn
碶	hpszhhhhszphpn
碷	hpszhpphsszhhh
碸	hpszhpzpszhshn
碹	hpszhnnzhszhhh
確	hpszhnzpsnhhhsh
碻	hpszhnhszhszszh
碼	hpszhhshhsznnnn
碽	hpszhhshszhhhpn
碾	hpszhzhphsshzpn
碿	hpszhzhpsnpszhh
磀	hpszhnphzspnzn
磁	hpszhnphzznzzn
磂	hpszhpznzpszhsh
磃	hpszhppshzphzpz
磄	hpszhnhpzhhsszh
磅	hpszhnhnpnznhzp
磆	hpszhszznzszhh
磇	hpszhpszpnhhzpz
磈	hpszhpszhhpzzn
磉	hpszhznznznhspn
磊	hpszhhpszhhpszh
磋	hpszhnphhhphsh
磌	hpszhhsszhhhhpn
磍	hpszhnnzhhhsszh
磎	hpszhpnnpzznhpn
磏	hpszhnphzhhsspn
磐	ppznhnpzznhpszh
磑	hpszhszshszhnph
磒	hpszhszhszhhhpn
磓	hpszhpszhzhnzn
磔	hpszhpznhzshspn
磕	hpszhhshznszssh
磖	hpszhznhznhpszhh
磗	hpszhhszhhsnhsn
磘	hpszhpnnpphhszs
磙	hpszhnhpnznpzpn
磚	hpszhhszhhshnhsn
磛	hszhhhspphshpszh
磜	hpszhpznnznhhspn
磝	hpszhhhshzpphpn
磞	hpszhszspzhhpzhh
磟	hpszhznhznhpnppp
磠	hpszhshszpnnnnnh
磡	hpszhhsshhhpnzzp
磢	hpszhhpnpnpnpnpn
磣	hpszhznznznpnppp
磤	hpszhppzhhzpzzn
磥	hpszhszhshzznspn
磦	hpszhhszsshhhspn
磧	hpszhhhshszhhhpn
磨	nhphspnhspnhpszh
磩	hpszhhpshhspnzpn
磪	hpszhszspsnhhhsh
磫	hpszhppspnpnshpn
磬	hshzshppzznhpszh
磭	hpszhhphhzpnszhh
磮	hpszhszspnhszhss
磯	hpszhzznzznhpnzpn
磰	hpszhnphhhsnphszh
磱	hpszhnppnnppnnzzp
磲	hpszhnnhhzhzhspn
磳	hpszhnpszsnphszhh
磴	hpszhznppnhszhnph
磵	hpszhszhhszhhszhh
磶	hpszhpshzhhpznnnn
磷	hpszhnphspnpznhzs
磸	hpszhnphszpzhhhpn
磹	hpszhhszsshszhhhs
磺	hpszhhsshszhshpn
磻	hpszhpnphspnszhsh
磼	hpszhpsnhhhshhspn
磽	hpszhhshhshhshhpz
磾	hpszhszhszhszhhhs
磿	hpphspnphspnhpszh
礀	hpszhszhhszhhpzhh
礁	hpszhpsnhhhshnnnn
礂	hpszhhshszhnphszh
礃	hpszhsnpnzszhphhs
礄	hpszhphpnszhszszh
礅	hpszhnhszhzshphpn
礆	hpszhpnhszhszhpnpn
礇	hpszhpsznphspnhpn
礈	hpszhnphpzpppnnzn
礉	hpszhpszhhnhzpphpn
礊	hszhhhszspzznhpszh
礋	hpszhszsshhshnphhs
礌	hpszhhnzsnnnnszhsh
礍	hpszhhssszhhpzpnz
礎	hpszhhspnhspnzshpn
礏	hpszhssnphnphhhspn
礐	pshhpnpnzhhnzhpszh
礑	hpszhsnpnzszhszhsh
礒	hpszhnphhshphshzpn
礓	hpszhhszhshhszhshh
礔	hpszhzhpszhnhnphhs
礕	zhpszhnhnphhshpszh
礖	hpszhpshhhzszhhhpn
礗	hpszhnnzhsppszhhhpn
礘	hpszhszhhzznzznnnnn
礙	hpszhpzphhpnznzshpn
礚	hpszhhsshshznszssh
礛	hpszhhszhszphnszssh
礜	pshhhzszhhhpnhpszh
礝	hpszhhnzsnnnnhpszss
礞	hpszhhssnzhhpzpppn
礟	hpszhhshhsznnnnpnpn
礠	hpszhnphzznzznnznn
礡	hpszhhsshszhhsnhsn
礢	hpszhnphhhpnnzhhzpn
礣	hpszhhssszsshhpnzpn
礤	hpszhhsspznnznhhspn
礥	hpszhhszhszznszhhhpn
礦	hpszhnhphsshszhshpn
礧	hpszhszhshszhshszhsh
礨	szhshszhshszhshhpszh
礩	hpszhpphspphsszhhhpn
礪	hpszhhphssszhhszshn
礫	hpszhpszhhzznzznhspn
礬	hspnpnpnhspnhpnhpszh
礭	hpszhhnzsnnnnpsnhhhsh
礮	hpszhhshhsznnnnnhpnpn
礯	hpszhnppnnppnnzzznspn
礰	hpszhhpphspnphspnshsh
礱	nhnphszhhshzhzhhhhpszh
礲	hpszhnhnphszhhshzhzhhh
礳	hpszhnhphspnhspnhpszh
礴	hpszhhssnnhhszhhsnhsn
礵	hpszhhnzsnnnnhspnszhhh
礶	hpszhhssszhszhpsnhhhsh
礷	hpszhhsshszhszphnszssh
礸	hpszhphshpzphshpzszhhhpn
礹	hpszhszhszhhpzhsshhhphpn
示	hhspn
礼	nzsnz
礽	nzsnzp
社	nzsnhsh
礿	nzsnpzn
祀	nzsnzhz
祁	nzsnzs
祂	nzsnzhz
祃	nzsnzzh
祄	nzsnpnps
祅	nzsnphpn
祆	nzsnhhpn
祇	nzsnpzhz
祈	nzsnpphs
祉	nzsnshsh
祊	nzsnnhzp
祋	nzsnpzzn
祌	nzsnszhs
祍	nzsnphsh
祎	nzsnhhzs
祏	nzsnhpszh
祐	nzsnhpszh
祑	nzsnphhpn
祒	nzsnzpszh
祓	nzsnhpznn
祔	nzsnpshsn
祕	nzsnnznpn
祖	nzsnszhhh
祗	nzsnpzhzn
祘	hhspnhhspn
祙	nzsnhhspn
祚	nzsnphshh
祛	nzsnhshzn
祜	nzsnhsszh
祝	nzsnszhpz
神	nzsnszhhs
祟	zsszshhspn
祠	nzsnzhszh
祡	shshpzhhspn
祢	nzsnpzspn
祣	nzsnphpzpn
祤	nzsnznhznh
祥	nzsnnphhhs
祦	nzsnszhhhpn
祧	nzsnpnhzpn
票	hszsshhhspn
祩	nzsnphhspn
祪	nzsnpzhpzz
祫	nzsnpnhszh
祬	nzsnhznhsh
祭	pznnznhhspn
祮	nzsnhshszh
祯	nzsnshszpn
祰	nzsnphshszh
祱	nzsnnpszhpz
祲	nzsnzhhnzzn
祳	nzsnhpsszpn
祴	nzsnhhpszpn
祵	nzsnszhspnh
祶	nzsnnpzhzsp
祷	nzsnhhhphsn
祸	nzsnszhszpn
祹	nzsnpzphhszs
祺	nzsnhsshhhpn
祻	nzsnszhsszhh
祼	nzsnszhhhspn
祽	nzsnnhpnpnhs
祾	nzsnhshpnpzn
祿	nzsnzzhsnhpn
禀	nhszszhhhhspn
禁	hspnhspnhhspn
禂	nzsnpzhshszh
禃	nzsnhsszhhhh
禄	nzsnzhhsnhpn
禅	nzsnnpszhhhs
禆	nzsnpszhhphs
禇	nzsnhshpszhh
禈	nzsnnzhszhhhs
禉	nzsnnphszpzhh
禊	nzsnhhhszphpn
禋	nzsnhszsshhsh
禌	nzsnnphzznzzn
禍	nzsnszzszszh
禎	nzsnshszhhhpn
福	nzsnhszhszhsh
禐	nzsnpnnphhpzn
禑	nzsnszhhszshn
禒	nzsnzzhpzpppn
禓	nzsnszhhhpzpp
禔	nzsnszhhhshpn
禕	nzsnzshszhhzs
禖	nzsnhsshhhspn
禗	nzsnszhshnznn
禘	nzsnnhnpnzszs
禙	nzsnshhpzszhh
禚	nzsnnphhshnnnn
禛	nzsnhsszhhhhpn
禜	nppnnppnnzhhspn
禝	nzsnszhshpnpzn
禞	nzsnnhszhszszh
禟	nzsnnhpzhhsszh
禠	nzsnppshzphzpz
禡	nzsnhshhsznnnn
禢	nzsnszhhznhznh
禣	nzsnhszhhsnhsn
禤	nzsnszsshznhznh
禥	nzsnhsshhhpnhsh
禦	ppsphhshshzshhspn
禧	nzsnhshszhnphszh
禨	nzsnzznzznhpnzpn
禩	nzsnszhshhsshpn
禪	nzsnszhszhszhhhs
禫	nzsnhszsshszhhhs
禬	nzsnpnhszsnphszhh
禭	nzsnnphpzpppnnzn
禮	nzsnszhsshhszhnph
禯	nzsnszhsshhphhzpn
禰	nzsnhpnszspnpnpnpn
禱	nzsnhshzhshhszhhsn
禲	nzsnhphssszhhszshn
禳	nzsnnhszhszhhhsshpzpn
禴	nzsnpnhszhszhszhszhss
禵	nzsnszhhhshpnhpszhhhpn
禶	nzsnphshpzphshpzszhhhpn
禷	nzsnnphspnhpnnhpszhhhpn
禸	szzn
禹	pszhszshn
禺	szhhszshn
离	nhpnzsszzn
禼	shszpnhszzn
禽	pnnhpnzsszzn
禾	phspn
禿	phspnpz
秀	phspnzp
私	phspnzn
秂	phspnpn
秃	phspnpz
秄	phspnzsh
秅	phspnphz
秆	phspnhhs
秇	phspnpzn
秈	phspnszs
秉	phzhhspn
秊	phspnphs
秋	phspnnppn
秌	nppnphspn
种	phspnszhs
秎	phspnpnzp
秏	phspnphhz
秐	phspnhhzn
科	phspnnnhs
秒	phspnspnp
秓	phspnhszn
秔	phspnnhpz
秕	phspnhzpz
秖	phspnpzhz
秗	phspnphpn
秘	phspnnznpn
秙	phspnhsszh
秚	phspnnphhs
秛	phspnzpszn
秜	phspnzhppz
秝	phspnphspn
秞	phspnszhsh
租	phspnszhhh
秠	phspnhpsnh
秡	phspnhpznn
秢	phspnpnnzn
秣	phspnhhspn
秤	phspnhnphs
秥	phspnshszh
秦	hhhpnphspn
秧	phspnszhpn
秨	phspnphshh
秩	phspnphhpn
秪	phspnpzhzn
秫	phspnhspnn
秬	phspnhzhz
秭	phspnpzsp
秮	phspnznszh
积	phspnszhpn
称	phspnpzspn
秱	phspnszhszh
秲	phspnhshhsn
秳	phspnphsszh
秴	phspnpnhszh
秵	phspnszhpnh
秶	nhpzpnphspn
秷	phspnhznhsh
秸	phspnhshszh
秹	phspnpsphsh
秺	phspnnnzphz
移	phspnpznpzn
秼	phspnphhspn
秽	phspnszspzn
秾	phspnnzpzpn
秿	phspnhszhhsn
稀	phspnpnhpszs
稁	nhszhnzphspn
稂	phspnnzhhzpn
稃	phspnpnnpzsh
稄	phspnznpnpzn
稅	phspnpnszhpz
稆	phspnszhszh
稇	phspnszhspnh
稈	phspnszhhhhs
稉	phspnhszhhpn
稊	phspnnpzhzsp
程	phspnszhhhsh
稌	phspnpnhhspn
稍	phspnsnpszhh
税	phspnnpszhpz
稏	phspnhshzzhsh
稐	phspnpnhszhss
稑	phspnhshpnhsh
稒	phspnszhsszhh
稓	phspnhsshszhh
稔	phspnpnnznznn
稕	phspnnhszhzsh
稖	phspnnhnphszh
稗	phspnpszhhphs
稘	phspnhsshhhpn
稙	phspnhsszhhhh
稚	phspnpsnhhhsh
稛	phspnszphspnh
稜	phspnhshpnpzn
稝	phspnpzhhpzhh
稞	phspnszhhhspn
稟	nhszszhhphspn
稠	phspnpzhshszh
稡	phspnnhpnpnhs
稢	phspnhszhhzpn
稣	pzszhshhphspn
稤	phspnnhszhspn
稥	phspnnnnnszhh
稦	phspnzshszhhzs
稧	phspnhhhszphpn
稨	phspnnzhpszhss
稩	phspnszhshszhh
稪	phspnphszhhpzn
稫	phspnhszhszhsh
稬	phspnhpszsshpn
稭	phspnhzpzpszhh
種	phspnphszhhshh
稯	phspnpnzspnpzn
稰	phspnzshpnszhh
稱	phspnpnnpszshh
稲	phspnpnnpsszhh
稳	phspnpzzhhnznn
稴	phspnnphzhhsspn
稵	phspnnphzznzzn
稶	phspnhszhhzpppn
稷	phspnszhshpnpzn
稸	phspnnhzznszhsh
稹	phspnhsszhhhhpn
稺	phspnzhpnhnphhs
稻	phspnpnnppshzhh
稼	phspnnnzhpzpppn
稽	phspnhpznpzszhh
稾	nhszhszszhphspn
稿	phspnnhszhszszh
穀	hshnzhphspnpzzn
穁	phspnhsshsshhh
穂	phspnhszhhsnznn
穃	phspnnnzpnpnszh
穄	phspnpznnznhhspn
穅	phspnnhpzhhsnhpn
穆	phspnpszhhspnppp
穇	phspnznznznpnppp
穈	nhphspnhspnphspn
穉	phspnzhpsnhpnphhs
穊	phspnzhhznhzpz
穋	phspnznhznhpnppp
穌	pzszhshnnnnphspn
積	phspnhhshszhhhpn
穎	pzphspnhpszhhhpn
穏	phspnpnnpzhhnznn
穐	phspnpzszhhszhhz
穑	phspnhsnphszszhh
穒	phspnpszhhhznnnn
穓	phspnszhshhsshpn
穔	phspnhsshszhshpn
穕	phspnpsnhhhshhspn
穖	phspnzznzznhpnzpn
穗	phspnhszhhshnnznn
穘	phspnhshhshhshhpz
穙	phspnssnphnphhhpn
穚	phspnphpnszhszszh
穛	phspnpsnhhhshnnnn
穜	phspnnhnphszhhshh
穝	phspnszhhhsshhhzn
穞	phspnpzszhshhszhh
穟	phspnnphpzpppnnzn
穠	phspnszhsshhphhzpn
穡	phspnhspnpnhszszhh
穢	phspnshshhphsppzpn
穣	phspnnhpnhhsshpzpn
穤	phspnhnzsnnnnhpszss
穥	phspnpshhhzszhhhpn
穦	phspnnnzhsppszhhhpn
穧	phspnnhnpszppznpshh
穨	phspnpzszhshszhhhpn
穩	phspnpnnphshzhhnznn
穪	phspnhpnszspnpnpnpn
穫	phspnhsspsnhhhshzn
穬	phspnnhphsshszhshpn
穭	phspnpzszhshnnnnszhh
穮	phspnnhpzsshhzpznnnn
穯	phspnhsszhszhhszszhh
穰	phspnnhszhszhhhsshpzpn
穱	phspnpnnpszsshzhhznhsn
穲	phspnhsznhsznnhpzsshhzpz
穳	phspnphshpzphshpzszhhhpn
穴	nnzpn
穵	nnzpnz
究	nnzpnpz
穷	nnzpnzp
穸	nnzpnpzn
穹	nnzpnzhz
空	nnzpnhsh
穻	nnzpnhhs
穼	nnzpnhspn
穽	nnzpnhhps
穾	nnzpnphpn
穿	nnzpnhzsp
窀	nnzpnhzsz
突	nnzpnhpnn
窂	nnzpnphhs
窃	nnzpnhzzp
窄	nnzpnphshh
窅	nnzpnszhhh
窆	nnzpnpnzn
窇	nnzpnpzzhz
窈	nnzpnzznzp
窉	nnzpnhszpn
窊	nnzpnppznn
窋	nnzpnzsszs
窌	nnzpnpzpzs
窍	nnzpnhshhz
窎	nnzpnpznzh
窏	nnzpnnnhhhs
窐	nnzpnhshhsh
窑	nnzpnphhszs
窒	nnzpnhznhsh
窓	nnzpnznnznn
窔	nnzpnnhpnpn
窕	nnzpnpnhzpn
窖	nnzpnphshszh
窗	nnzpnpszpznh
窘	nnzpnzhhpszh
窙	nnzpnhshpzsh
窚	nnzpnhpzzpn
窛	nnzpnhhpzzph
窜	nnzpnszhszhs
窝	nnzpnszhszpn
窞	nnzpnpzpshzhh
窟	nnzpnzhpzsszs
窠	nnzpnszhhhspn
窡	nnzpnznznznzn
窢	nnzpnhszhhzpn
窣	nnzpnnhpnpnhs
窤	nnzpnszhhhzpz
窥	nnzpnhhpnszpz
窦	nnzpnhsznnhpn
窧	nnzpnshszhhhs
窨	nnzpnnhnphszhh
窩	nnzpnszzszszh
窪	nnzpnnnhhshhsh
窫	nnzpnhhhszphpn
窬	nnzpnpnhszhhss
窭	nnzpnnphspnzph
窮	nnzpnpszhhhpzhz
窯	nnzpnnphhshnnnn
窰	nnzpnpnnpphhszs
窱	nnzpnpsspznhspn
窲	nnzpnnphspnnnhs
窳	nnzpnppznnppznn
窴	nnzpnhsszhhhhpn
窵	nnzpnpszhhhznnnn
窶	nnzpnszhhszhszph
窷	nnzpnhsshhhpzpzs
窸	nnzpnpnphspnnznn
窹	nnzpnzshphszhszh
窺	nnzpnhhpnszhhhpz
窻	nnzpnpszpznhnznn
窼	nnzpnzzzszhhhspn
窽	nnzpnpzphhpnpzpn
窾	nnzpnhshhhspnpzpn
窿	nnzpnzspznhphhsh
竀	nnzpnhshshszhhhpz
竁	nnzpnphhzphhzphhz
竂	nnzpnhpnnpszhhspn
竃	nnzpnhshszhhszhhz
竄	nnzpnpshzhhznnznnz
竅	nnzpnpszhhnhzpphpn
竆	nnzpnpszhhhpszhszh
竇	nnzpnhshszsshszhhhpn
竈	nnzpnhshszhhszhshhzhh
竉	nnzpnnhnphszhhshzhzhhh
竊	nnzpnpnphspnshszpnszzn
立	nhnph
竌	nhnphpz
竍	nhnphhs
竎	nhnphhps
竏	nhnphphs
竐	nhnphpzzn
竑	nhnphhpzn
竒	nhnphszhs
竓	nhnphphhz
竔	nhnphphps
竕	nhnphpnzp
竖	ssznnhnph
竗	nhnphspnp
竘	nhnphpzszh
站	nhnphshszh
竚	nhnphnnzhs
竛	nhnphpnnzn
竜	nhnphszhhz
竝	nhnphnhnph
竞	nhnphszhpz
竟	nhnphszhhpz
章	nhnphszhhhs
竡	nhnphhpszhh
竢	nhnphznphhpn
竣	nhnphznpnpzn
竤	nhnphnnzhpzn
童	nhnphszhhshh
竦	nhnphhszhspn
竧	nhnphpszhhhp
竨	nhnphshszhhhs
竩	nhnphnnzszhhh
竪	hszhszznnhnph
竫	nhnphpzzhhs
竬	nhnphpszhszshn
竭	nhnphszhhpzpnz
竮	nhnphzhpnphhps
端	nhnphszshpszss
竰	nhnphhpszhhshh
竱	nhnphhszhhshnhsn
竲	nhnphnpszsnphszhh
竳	nhnphznppnhszhnph
竴	nhnphnphszpzhhhsn
竵	nhnphhszhhzssznphs
競	nhnphszhpznhnphszhpz
竷	nhnphszhhhspznhzspzn
竸	nhnphszhhpznhnphszhhpz
竹	phsphs
竺	phnphnhh
竻	phnphnzp
竼	phnphnpzn
竽	phnphnhhs
竾	phnphnzsz
竿	phnphnhhs
笀	phnphnnhz
笁	phnphnhsh
笂	phnphnpzn
笃	phnphnzzh
笄	phnphnhhps
笅	phnphnpnpn
笆	phnphnzshz
笇	phnphnnhsn
笈	phnphnpzn
笉	phnphnpznh
笊	phnphnppsn
笋	phnphnzhhp
笌	phnphnhzsp
笍	phnphnszpn
笎	phnphnhhpz
笏	phnphnpzpp
笐	phnphnnhpz
笑	phnphnphpn
笒	phnphnpnnz
笓	phnphnhzpz
笔	phnphnphhz
笕	phnphnszpz
笖	phnphnznpn
笗	phnphnpznnn
笘	phnphnshszh
笙	phnphnphhsh
笚	phnphnszhhs
笛	phnphnszhsh
笜	phnphnzsszs
笝	phnphnszznh
笞	phnphnznszh
笟	phnphnppznn
笠	phnphnnhnph
笡	phnphnszhhh
笢	phnphnzhzhz
笣	phnphnpzzhz
笤	phnphnzpszh
笥	phnphnzhszh
符	phnphnpshsn
笧	phnphnpzpzh
笨	phnphnhspnh
笩	phnphnpshzn
笪	phnphnszhhh
笫	phnphnpzsp
第	phnphnzhzsp
笭	phnphnpnnzn
笮	phnphnphshh
笯	phnphnzphzn
笰	phnphnzhzps
笱	phnphnpzszh
笲	phnphnznhps
笳	phnphnzpszh
笴	phnphnhszhs
笵	phnphnnnhzz
笶	phnphnphhpn
笷	phnphnpzpzs
笸	phnphnhszhz
笹	phnphnhsshz
笺	phnphnhhzpn
笻	phnphnhshzs
笼	phnphnhpzpn
笽	phnphnszssh
笾	phnphnzpnzn
笿	phnphnpznszh
筀	phnphnhshhsh
筁	phnphnszhssh
筂	phnphnnnhzsz
筃	phnphnszhpnh
筄	phnphnpnhzpn
筅	phnphnphshpz
筆	phnphnzhhhhs
筇	phnphnhshzs
筈	phnphnphsszh
等	phnphnhshhsn
筊	phnphnnhpnpn
筋	phnphnpzhhzp
筌	phnphnpnhhsh
筍	phnphnpzszhh
筎	phnphnzphszh
筏	phnphnpshzpn
筐	phnphnhhhshz
筑	phnphnhshpzn
筒	phnphnszhszh
筓	phnphnhhphhs
答	phnphnpnhszh
筕	phnphnppshhs
策	phnphnhszspn
筗	phnphnpsszhs
筘	phnphnhshszh
筙	phnphnhhhspn
筚	phnphnhzpzhs
筛	phnphnsphszs
筜	phnphnsnpzhh
筝	phnphnpzzhhs
筞	phnphnnnzhspn
筟	phnphnpnnpzsh
筠	phnphnhshpznh
筡	phnphnpnhhspn
筢	phnphnhshzshz
筣	phnphnphspnss
筤	phnphnnzhhzpn
筥	phnphnszhszh
筦	phnphnnnzhhpz
筧	phnphnszhhhpz
筨	phnphnpnnzszh
筩	phnphnznszhhs
筪	phnphnhszhhsz
筫	phnphnszhhhpn
筬	phnphnhpzzpn
筭	phnphnhhshhps
筮	phnphnhspnpnh
筯	phnphnszhhhzp
筰	phnphnpsphshh
筱	phnphnpssphpn
筲	phnphnsnpszhh
筳	phnphnphshzn
筴	phnphnhpnpnpn
筵	phnphnpshzzn
筶	phnphnphshszh
筷	phnphnnnszhpn
筸	phnphnszhhhhs
筹	phnphnhhhphsn
筺	phnphnhhhshnz
筻	phnphnhszhhpn
筼	phnphnszhszpn
筽	phnphnszhhhpn
签	phnphnpnhnnph
筿	phnphnpznhspn
简	phnphnnszszhh
箁	phnphnnhnphszh
箂	phnphnhpnpnspn
箃	phnphnhsshhhzn
箄	phnphnpszhhphs
箅	phnphnszhshhps
箆	phnphnszpnhzpz
箇	phnphnszhsszhh
箈	phnphnnnhznszh
箉	phnphnhshszhzp
箊	phnphnnhzppnnn
箋	phnphnhzpnhzpn
箌	phnphnhznhshss
箍	phnphnhshhszsz
箎	phnphnshzphzpz
箏	phnphnpnnpzhhs
箐	phnphnhhshszhh
箑	phnphnhzhhshpn
箒	phnphnzhhnzszs
箓	phnphnzhhsnhpn
箔	phnphnnnhpszhh
箕	phnphnhsshhhpn
箖	phnphnhspnhspn
算	phnphnszhhhhps
箘	phnphnszphspnh
箙	phnphnpzhhzszn
箚	phnphnpnhszhss
箛	phnphnzshppznn
箜	phnphnnnzpnhsh
箝	phnphnhshhsshh
箞	phnphnnphhpnzz
箟	phnphnszhhhzpz
箠	phnphnphshsshh
管	phnphnnnzszhzh
箢	phnphnnnzpznzz
箣	phnphnhszspnss
箤	phnphnnhpnpnhs
箥	phnphnnnhzpszn
箦	phnphnhhshszpn
箧	phnphnhhnphpnz
箨	phnphnhshznhhs
箩	phnphnszsshpzn
箪	phnphnnpszhhhs
箫	phnphnzhhspspn
箬	phnphnhsshpszh
箭	phnphnnphszhhss
箮	phnphnnnzhszhhh
箯	phnphnpshszhhpn
箰	phnphnpzszhhzsh
箱	phnphnhspnszhhh
箲	phnphnnnhphshpz
箳	phnphnzhpnphhps
箴	phnphnhphszhzpn
箵	phnphnspnpszhhh
箶	phnphnhsszhpzhh
箷	phnphnnhzpphzsz
箸	phnphnhshpszhh
箹	phnphnzznnnnpzn
箺	phnphnhhhpnszhh
箻	phnphnppszhhhhs
箼	phnphnzhphznhsh
箽	phnphnphszhhshh
箾	phnphnsnpszhhss
箿	phnphnszhhsshhh
節	phnphnzhhznzs
篁	phnphnpszhhhhsh
篂	phnphnszhhphhsh
篃	phnphnzshpszhhh
範	phnphnhszhhhszz
篅	phnphnszshpszss
篆	phnphnzzhpzpppn
篇	phnphnnzhpszhss
篈	phnphnhshhshhsn
築	phnphnhshpznhspn
篊	phnphnnnhhsshpn
篋	phnphnhhpnpnpnz
篌	phnphnpszhphhpn
篍	phnphnphspnnppn
篎	phnphnszhhhspnp
篏	phnphnhsshhpzpn
篐	phnphnhspnhszsz
篑	phnphnszhshszpn
篒	phnphnpnnzhhzpn
篓	phnphnnphspnzph
篔	phnphnszhszhhhpn
篕	phnphnhshznszssh
篖	phnphnnhpzhhsszh
篗	phnphnpsnhhhshzn
篘	phnphnpzzsppzzsp
篙	phnphnnhszhszszh
篚	phnphnhshhhshhhz
篛	phnphnzhznhzhznh
篜	phnphnzszpnhnnnn
篝	phnphnhhsshszshh
篞	phnphnnnhszhhhsh
篟	phnphnpshhshszhh
篠	phnphnpsspznhspn
篡	phnphnszhhhhpnzn
篢	phnphnhshszhhhpn
篣	phnphnnhnpnznhzp
篤	phnphnhshhsznnnn
篥	phnphnhszsshhspn
篦	phnphnpszpnhhzpz
篧	phnphnnzpsnhhhsh
篨	phnphnzspnhhspn
篩	phnphnpszhzhhszs
篪	phnphnppshzphzpz
篫	phnphnhshpznphhs
篬	phnphnpnnzhhpszh
篭	phnphnnhnphszhhz
篮	phnphnssphnszssh
篯	phnphnphhhzhhzpn
篰	phnphnnhnphszhzs
篱	phnphnnhpnzsszzn
篲	phnphnhhhshhhszhh
篳	phnphnszhhhsshhs
篴	phnphnhpzpppnnzn
篵	phnphnppspnpnshpn
篶	phnphnhshshhznnnn
篷	phnphnpznhhhsnzn
篸	phnphnznznznpnppp
篹	phnphnszhhhhpnzz
篺	phnphnhshpszhhphs
篻	phnphnhszsshhhspn
篼	phnphnpszhhpzzhpz
篽	phnphnppsphhshshzs
篾	phnphnszsshhpnzpn
篿	phnphnhszhhshnhsn
簀	phnphnhhshszhhhpn
簁	phnphnppsshshshpn
簂	phnphnszhszhhzpnh
簃	phnphnphspnpznpzn
簄	phnphnnzhpszhzshz
簅	phnphnnhnphpphhsh
簆	phnphnnnzhhpzphpn
簇	phnphnnhzpphphhpn
簈	phnphnzhpphhpphhs
簉	phnphnphshszhnzn
簊	phnphnhsshhhpnhsh
簋	phnphnzhhzpnszssh
簌	phnphnhszhspnpzpn
簍	phnphnszhhszhszph
簎	phnphnhshhsshszhh
簏	phnphnnhpzsshhzpz
簐	phnphnhszhhhspzpn
簑	phnphnnhszhhpzpn
簒	phnphnszhhhhpnpzn
簓	phnphnpzhshszhppp
簔	phnphnnhhsshhpzpn
簕	phnphnhsshszhhszp
簖	phnphnnphspnzpphs
簗	phnphnnnhzpnnhspn
簘	phnphnzhhsnphpnps
簙	phnphnhshszhhsnhsn
簚	phnphnszsshhszszpn
簛	phnphnhsshhhpnpphs
簜	phnphnnnhszhhhpzpp
簝	phnphnhpnnpszhhspn
簞	phnphnszhszhszhhhs
簟	phnphnhszsshszhhhs
簠	phnphnhszhhsnszssh
簡	phnphnszhhszhhszhh
簢	phnphnszhhszhhnhpn
簣	phnphnszhshszhhhpn
簤	phnphnszsshszhhhpn
簥	phnphnphpnszhszszh
簦	phnphnznppnhszhnph
簧	phnphnhsshszhshpn
簨	phnphnzhzzhzhsshpn
簩	phnphnnppnnppnnzzp
簪	phnphnhzpzhzpzszhh
簫	phnphnzhhspshhzzshs
簬	phnphnszhshshpznszh
簭	phnphnhspnpnhpnszh
簮	phnphnhhpnhhpnszhh
簯	phnphnhspnhsshhhpn
簰	phnphnpshzpszhhphs
簱	phnphnnhzphsshhhpn
簲	phnphnpzhhpszhhphs
簳	phnphnhsszhhhspnhhs
簴	phnphnshzphzssnphpn
簵	phnphnhszhhhspznszh
簶	phnphnnzsnzhhsnhpn
簷	phnphnpzhppnnhhhszh
簸	phnphnhsshhhpnzpszn
簹	phnphnsnpnzszhszhsh
簺	phnphnnnzhhsshpnhsh
簻	phnphnszzszszhnzn
簼	phnphnhshhhsshszshh
簽	phnphnpnhszhszhpnpn
簾	phnphnnhpnphzhhsspn
簿	phnphnnnhhszhhsnhsn
籀	phnphnhshpznzpszhsh
籁	phnphnhszhspnpzszpn
籂	phnphnpnnzhhznphszs
籃	phnphnhszhszphnszssh
籄	phnphnhszhshszhhhpnz
籅	phnphnpshhhzszhhhpn
籆	phnphnhsspsnhhhshzn
籇	phnphnnhszhnzhpzpppn
籈	phnphnhszsshhshhzzn
籉	phnphnhshszhnzhznhsh
籊	phnphnznhznhpsnhhhsh
籋	phnphnhpnszspnpnpnpn
籌	phnphnhshzhshhszhhsn
籍	phnphnhhhspnhsshszhh
籎	phnphnpzphhpnznzshpn
籏	phnphnnhzpphhsshhhpn
籐	phnphnpzhhnphhpnsnhpn
籑	phnphnszhhhhpnnzhhzpn
籒	phnphnhshhsshzzhszhsh
籓	phnphnnnhpnphspnszhsh
籔	phnphnszhhszhszphphpn
籕	phnphnhspnpznzpszhsh
籖	phnphnhshshhhshhhhzpn
籗	phnphnhnzsnnnnpsnhhhsh
籘	phnphnpzhhnphhpnzznspn
籙	phnphnpnhhsnphzhhsnhpn
籚	phnphnshzphzszhshszssh
籛	phnphnpnhhsnphhzpnhzpn
籜	phnphnhshszsshhshnphhs
籝	phnphnnhzszhpzhhzphpzn
籞	phnphnppsphhshshzshhspn
籟	phnphnhszhspnpzszhhhpn
籠	phnphnnhnphszhhshzhzhhh
籡	phnphnhshpnhszhszhpnpn
籢	phnphnpnhszhszhpnpnphpn
籣	phnphnszhhszhhhsznphspn
籤	phnphnpnpnhshhhshhhhzpn
籥	phnphnpnhszhszhszhszhss
籦	phnphnpnhhsnphphszhhshh
籧	phnphnshzphzhpzpppnnzn
籨	phnphnpnhszhszhpnpnpzpn
籩	phnphnpszhhhnnzpnnhzpnzn
籪	phnphnzznzznhzznzznzpphs
籫	phnphnphshpzphshpzszhhhpn
籬	phnphnnhpnzsszznpsnhhhsh
籭	phnphnhsznhsznnhpzsshhzpz
籮	phnphnszsshzznnnnpsnhhhsh
米	nphspn
籴	pnnphspn
籵	nphspnhs
籶	nphspnpz
籷	nphspnphz
籸	nphspnzhs
籹	nphspnzph
籺	nphspnphz
类	nphspnhpn
籼	nphspnszs
籽	nphspnzsh
籾	nphspnzpn
籿	nphspnhsn
粀	nphspnhpn
粁	nphspnphs
粂	pznnphspn
粃	nphspnhzpz
粄	nphspnppzn
粅	nphspnpzpp
粆	nphspnspnp
粇	nphspnnhpz
粈	nphspnzshh
粉	nphspnpnzp
粊	hzpznphspn
粋	nphspnpzhs
粌	nphspnzhzs
粍	nphspnphhz
粎	nphspnzhpn
粏	nphspnhpnn
粐	nphspnnzhp
粑	nphspnzshz
粒	nphspnnhnph
粓	nphspnhsshh
粔	nphspnhzhz
粕	nphspnpszhh
粖	nphspnhhspn
粗	nphspnszhhh
粘	nphspnshszh
粙	nphspnszhsh
粚	nphspnphzsz
粛	zhhsnphpnps
粜	zsszsnphspn
粝	nphspnhphzp
粞	nphspnhszpzh
粟	hszsshnphspn
粠	nphspnhsshpn
粡	nphspnszhszh
粢	nhpzpnnphspn
粣	nphspnpzpzh
粤	psznphspnhhz
粥	zhznphspnzhz
粦	nphspnpznhzs
粧	nphspnnhphsh
粨	nphspnhpszhh
粩	nphspnhshppz
粪	nphspnhsshpn
粫	nphspnhpszss
粬	nphspnszhssh
粭	nphspnpnhszh
粮	nphspnnzhhzpn
粯	nphspnszhhhpz
粰	nphspnpnnpzsh
粱	nnhzpnnnphspn
粲	shpznznnphspn
粳	nphspnhszhhpn
粴	nphspnszhhshh
粵	pszpnphspnhhz
粶	nphspnzhhsnhpn
粷	nphspnpznphspn
粸	nphspnhsshhhpn
粹	nphspnnhpnpnhs
粺	nphspnpszhhphs
粻	nphspnhshhhzpn
粼	nphspnpznhzszz
粽	nphspnnnzhhspn
精	nphspnhhshszhh
粿	nphspnszhhhspn
糀	nphspnhsspspz
糁	nphspnznhpnppp
糂	nphspnhsshhhpnz
糃	nphspnszhhhpzpp
糄	nphspnnzhpszhss
糅	nphspnznzsphspn
糆	nphspnhpszsshhh
糇	nphspnpszhphhpn
糈	nphspnzshpnszhh
糉	nphspnpnzspnpzn
糊	nphspnhsszhpzhh
糋	nphspnnphszhhss
糌	nphspnpznsnszhh
糍	nphspnnphzznzzn
糎	nphspnhpszhhshh
糏	nphspnzhpsnpszhh
糐	nphspnhszhhsnhsn
糑	nphspnzhznhzhznh
糒	nphspnhsshpszhhs
糓	hshnzhnphspnpzzn
糔	nphspnznnszhshn
糕	nphspnnphhshnnnn
糖	nphspnnhpzhhsszh
糗	nphspnpszhhhhpnn
糘	nphspnnnzhpzpppn
糙	nphspnphshszhnzn
糚	nphspnhsszshphsh
糛	nphspnsnpnzszhhsh
糜	nhphspnhspnnphspn
糝	nphspnznznznpnppp
糞	nphspnszhshhsshpn
糟	nphspnhszhsshszhh
糠	nphspnnhpzhhsnhpn
糡	nphspnnhnphszhhpz
糢	nphspnhssszhhhpn
糣	nphspnhzpzhzpzszhh
糤	nphspnhsshszhhphpn
糥	nphspnhpszsshpszss
糦	nphspnhshszhnphszh
糧	nphspnszhhhszhhshh
糨	nphspnzhzszhszhshn
糩	nphspnpnhszsnphszhh
糪	zhpszhnhnphhsnphspn
糫	nphspnszsshhszhpzpn
糬	nphspnszsshhshpszhh
糭	nphspnpnnnnnzspnpzn
糮	nphspnhszhszphnszssh
糯	nphspnhnzsnnnnhpszss
糰	nphspnszhszhhshnhsnh
糱	zsppszhzhnhnphhsnphspn
糲	nphspnhphssszhhszshn
糳	ssnphnphhspshzhhpzznnphspn
糴	pnnphspnznhznhpsnhhhsh
糵	hsspszhzhnhnphhsnphspn
糶	zsszsnphspnznhznhpsnhhhsh
糷	nphspnhssszhhszhhhsznphspn
糺	zznnnnz
系	pzznspn
糼	zznnnnzp
糽	zznnnnhs
糾	zznnnnzs
糿	zznnnnzp
紀	zznnnnzhz
紁	zznnnnznn
紂	zznnnnhsn
紃	zznnnnpss
約	zznnnnpzn
紅	zznnnnhsh
紆	zznnnnhhs
紇	zznnnnphz
紈	zznnnnpzn
紉	zznnnnzpn
紊	nhpnzznspn
紋	zznnnnnhpn
紌	zznnnnhpzn
納	zznnnnszpn
紎	zznnnnhpnn
紏	zznnnnnnhs
紐	zznnnnzshh
紑	zznnnnhpsn
紒	zznnnnpnps
紓	zznnnnznzs
純	zznnnnhzsz
紕	zznnnnhzpz
紖	zznnnnzhzs
紗	zznnnnspnp
紘	zznnnnhpzn
紙	zznnnnpzhz
級	zznnnnpzn
紛	zznnnnpnzp
紜	zznnnnhhzn
紝	zznnnnphsh
紞	zznnnnnzpz
紟	zznnnnpnnz
素	hhshzznspn
紡	zznnnnnhzp
索	hsnzzznspn
紣	zznnnnpzhs
紤	zznnnnpphs
紥	hshzzznspn
紦	zznnnnzshz
紧	ssznzznspn
紨	zznnnnpshsn
紩	zznnnnphhpn
紪	zznnnnshshpz
紫	shshpzzznspn
紬	zznnnnszhsh
紭	zznnnnzhzzn
紮	hspnzzznspn
累	szhshzznspn
細	zznnnnszhsh
紱	zznnnnhpznn
紲	zznnnnhsshz
紳	zznnnnszhhs
紴	zznnnnzpszn
紵	zznnnnnnzhs
紶	zznnnnhshzn
紷	zznnnnpnnzn
紸	zznnnnnhhsh
紹	zznnnnzpszh
紺	zznnnnhsshh
紻	zznnnnszhpn
紼	zznnnnzhzps
紽	zznnnnnnzpz
紾	zznnnnpnppp
紿	zznnnnznszh
絀	zznnnnzsszs
絁	zznnnnphzsz
終	zznnnnpznnn
絃	zznnnnnhzzn
組	zznnnnszhhh
絅	zznnnnszszh
絆	zznnnnnphhs
絇	zznnnnpzszh
絈	zznnnnpszhh
絉	zznnnnhspnn
絊	zznnnnhspnh
絋	zznnnnnhpzn
経	zznnnnznhsh
絍	zznnnnpsphsh
絎	zznnnnppshhs
絏	zznnnnszhhzp
結	zznnnnhshszh
絑	zznnnnphhspn
絒	zznnnnnpnsns
絓	zznnnnhshhsh
絔	zznnnnhpszhh
絕	zznnnnzpzshz
絖	zznnnnsnphpz
絗	zznnnnszszhh
絘	zznnnnnhpzpn
絙	zznnnnhszhhh
絚	zznnnnhsznnh
絛	psspznzznspn
絜	hhhszpzznspn
絝	zznnnnhpnhhz
絞	zznnnnnhpnpn
絟	zznnnnpnhhsh
絠	zznnnnhpszhh
絡	zznnnnpznszh
絢	zznnnnpzszhh
絣	zznnnnnphhps
絤	zznnnnhszpzh
絥	zznnnnpshpnn
給	zznnnnpnhszh
絧	zznnnnszhszh
絨	zznnnnhhpzpn
絩	zznnnnpnhzpn
絪	zznnnnszhpnh
絫	znznznzznspn
絬	zznnnnphsszh
絭	nphhpnzznspn
絮	zphszhzznspn
絯	zznnnnnhzppn
絰	zznnnnhznhsh
統	zznnnnnhznpz
絲	zznnnnzznspn
絳	zznnnnpznhzs
絴	zznnnnnphhhs
絵	zznnnnpnhhzn
絶	zznnnnpzzshz
絷	hshpznzznspn
絸	zznnnnszhhhpz
絹	zznnnnszhszhh
絺	zznnnnpnhpszs
絻	zznnnnpzszhpz
絼	zznnnnpnnpzpp
絽	zznnnnszhszh
絾	zznnnnhpzzpn
絿	zznnnnhsnhpnn
綀	zznnnnhszhspn
綁	zznnnnhhhpzs
綂	zznnnnnhszhpz
綃	zznnnnsnpszhh
綄	zznnnnnnzsspz
綅	zznnnnzhhnzzn
綆	zznnnnhszhhpn
綇	zznnnnhszpzhh
綈	zznnnnnpzhzsp
綉	zznnnnphspnzp
綊	zznnnnhpnpnpn
綋	zznnnnnnzhpzn
綌	zznnnnpnpnszh
綍	zznnnnhsnzzsh
綎	zznnnnphshzn
綏	zznnnnpnnpzph
綐	zznnnnnpszhpz
綑	zznnnnszhspnh
綒	zznnnnpnnpzsh
經	zznnnnhzzzhsh
綔	hpnhhzpzznspn
綕	zznnnnhshnznn
綖	zznnnnpshzzn
綗	zznnnnszpnszh
綘	zznnnnpznhhhs
継	zznnnnnphspnz
続	zznnnnhshnzpz
綛	zznnnnzpnnznn
綜	zznnnnnnzhhspn
綝	zznnnnhspnhspn
綞	zznnnnphshsshh
綟	zznnnnnzhphpnn
綠	zznnnnzzhsnhpn
綡	zznnnnnhszhspn
綢	zznnnnpzhshszh
綣	zznnnnnphhpnzz
綤	zpszhzszznspn
綥	zznnnnszhshhps
綦	hsshhhpnzznspn
綧	zznnnnnhszhzsh
綨	zznnnnhsshhhpn
綩	zznnnnnnzpznzz
綪	zznnnnhhshszhh
綫	zznnnnhzpnhzpn
綬	zznnnnpnnpnzzn
維	zznnnnpsnhhhsh
綮	nzhpphpnzznspn
綯	zznnnnpzphhszs
綰	zznnnnnnzszhzh
綱	zznnnnsznphszs
網	zznnnnsznphnhz
綳	zznnnnpzhhpzhh
綴	zznnnnznznznzn
綵	zznnnnpnnphspn
綶	zznnnnszhhhspn
綷	zznnnnnhpnpnhs
綸	zznnnnpnhszhss
綹	zznnnnpznsnszh
綺	zznnnnhpnhszhs
綻	zznnnnnnzhshpn
綼	zznnnnpszhhphs
綽	zznnnnshszhhhs
綾	zznnnnhshpnpzn
綿	zznnnnpszhhszs
緀	zznnnnhzhhszph
緁	zznnnnhzhhshpn
緂	zznnnnnppnnppn
緃	zznnnnpnpnshpn
緄	zznnnnszhhhzpz
緅	zznnnnhsshhhzn
緆	zznnnnszhhpzpp
緇	zznnnnzzzszhsh
緈	zznnnnhshnphhs
緉	zznnnnhszspnpn
緊	hszhszznzznspn
緋	zznnnnshhhshhh
緌	zznnnnphspnzph
緍	zznnnnpzhzszhh
緎	zznnnnhszhhzpn
総	zznnnnpnznnznn
緐	phzznhnpzznspn
緑	zznnnnzhhsnhpn
緒	zznnnnhshpszhh
緓	zznnnnhssszhpn
緔	zznnnnsnpszszh
緕	zznnnnnhpnpshh
緖	zznnnnhshpszhhn
緗	zznnnnhspnszhhh
緘	zznnnnhphszhzpn
緙	zznnnnhsshszhhs
線	zznnnnpszhhszpn
緛	zznnnnhpszsshpn
緜	pszhhszspzznspn
緝	zznnnnszhhsshhh
緞	zznnnnpshhhpzzn
緟	zznnnnphszhhshh
締	zznnnnnhnpnzszs
緡	zznnnnzhzhzszhh
緢	zznnnnhssszhsh
緣	zznnnnzzhpzpppn
緤	zznnnnhsshzhspn
緥	zznnnnpsszhhspn
緦	zznnnnszhshnznn
緧	zznnnnnphszpzhh
編	zznnnnnzhpszhss
緩	zznnnnpnnphhpzn
緪	zznnnnnnshsznnh
緫	zznnnnpzppnnznn
緬	zznnnnhpszsshhh
緭	zznnnnszhshszhh
緮	zznnnnphszhhpzn
緯	zznnnnzshszhhzs
緰	zznnnnpnhszhhss
緱	zznnnnpszhphhpn
緲	zznnnnszhhhspnp
緳	nhphhhszpzznspn
練	zznnnnhsznphspn
緵	zznnnnpnzspnpzn
緶	zznnnnpshszhhpn
緷	zznnnnnzhszhhhs
緸	zznnnnhszsshhsh
緹	zznnnnszhhhshpn
緺	zznnnnszzszszh
緻	zznnnnhznhshphpn
緼	zznnnnszhhszssh
緽	zznnnnshszhhhpn
緾	zznnnnhpszhhshh
緿	zznnnnznszhnznn
縀	zznnnnzhshhzhzn
縁	zznnnnzhhpzpppn
縂	zznnnnnpszhnznn
縃	zznnnnzshpnszhh
縄	zznnnnszhhszhhz
縅	zznnnnhphzphzpn
縆	zznnnnnnshszhhh
縇	zznnnnnnzhszhhh
縈	nppnnppnnzzznspn
縉	zznnnnhssnphszhh
縊	zznnnnnphpnszssh
縋	zznnnnpszhzhnzn
縌	zznnnnnphzspnzn
縍	zznnnnnhnpnznhzp
縎	zznnnnszznzszhh
縏	ppznhnpzznzznspn
縐	zznnnnpzzsppzzsp
縑	zznnnnnphzhhsspn
縒	zznnnnnphhhphsh
縓	zznnnnhppszhhspn
縔	zznnnnznznznhspn
縕	zznnnnszpnhszssh
縖	zznnnnnnzhhhsszh
縗	zznnnnnhszhhpzpn
縘	zznnnnpnnpzznhpn
縙	zznnnnhsshsshhh
縚	zznnnnpnnppshzhh
縛	zznnnnhszhhsnhsn
縜	zznnnnszhszhhhpn
縝	zznnnnhsszhhhhpn
縞	zznnnnnhszhszszh
縟	zznnnnhphhzpnhsn
縠	hshnzhzznspnpzzn
縡	zznnnnnnznhnphhs
縢	pzhhnphhpnzznspn
縣	szhhhhspnpzznspn
縤	zznnnnhhshzznspn
縥	zznnnnhhhpnphspn
縦	zznnnnppsnphshpn
縧	zznnnnpsspznhspn
縨	zznnnnszhhsnphpz
縩	zznnnnpznnznhhspn
縪	zznnnnszhhhsshhs
縫	zznnnnpznhhhsnzn
縬	zznnnnhpshhspnzpn
縭	zznnnnnhpnzsszzn
縮	zznnnnnnzpshpszhh
縯	zznnnnnnzhszhshpn
縰	zznnnnppsshshshpn
縱	zznnnnppspnpnshpn
縲	zznnnnszhshzznspn
縳	zznnnnhszhhshnhsn
縴	zznnnnnhzznnzphhs
縵	zznnnnszhhszsshzn
縶	hshnphhspznzznspn
縷	zznnnnszhhszhszpn
縸	zznnnnhssszhhhpn
縹	zznnnnhszsshhhspn
縺	zznnnnhszhhhsnzn
縻	nhphspnhspnzznspn
縼	zznnnnnhzpphzshpn
總	zznnnnpszpznhnznn
績	zznnnnhhshszhhhpn
縿	zznnnnznznznpnppp
繀	zznnnnszspsnhhhsh
繁	phzznhnphpnzznspn
繂	zznnnnnhzznnhpnhs
繃	zznnnnszspzhhpzhh
繄	hphhpnzpzznzznspn
繅	zznnnnzzzszhhhspn
繆	zznnnnznhznhpnppp
繇	pnnpphhszspzznspn
繈	zznnnnzhzznszhshn
繉	zznnnnszhhhpnhzpn
繊	zznnnnhshssnphzpn
繋	hszhhhspzznzznspn
繌	zznnnnpszpnhpnpzn
繍	zznnnnzhhsnphpnps
繎	zznnnnpznnhpnnnnnn
繏	zznnnnzhzzhzhsshpn
繐	zznnnnhszhhshnnznn
繑	zznnnnphpnszhszszh
繒	zznnnnnpszsnphszhh
繓	zznnnnszhhhsshhhzn
織	zznnnnnhnphszhhzpn
繕	zznnnnnphhhsnphszh
繖	zznnnnhsshszhhphpn
繗	zznnnnnphspnpznhzs
繘	zznnnnznzspszpnszh
繙	zznnnnpnphspnszhsh
繚	zznnnnhpnnpszhhspn
繛	hhshzznspnshszhhhs
繜	zznnnnnphszpzhhhsn
繝	zznnnnszhhszhhpzhh
繞	zznnnnhshhshhshhpz
繟	zznnnnszhszhszhhhs
繠	nznnnznnnznnzznspn
繡	zznnnnzhhspshhzzshs
繢	zznnnnszhshszhhhpn
繣	zznnnnzhhshhszhshh
繤	hssszhhhhpnzznspn
繥	zznnnnhshszhnphszh
繦	zznnnnzhzszhszhshn
繧	zznnnnhnzsnnnnhhzn
繨	zznnnnhshnphhhsnzn
繩	zznnnnszhhszhshhzhh
繪	zznnnnpnhszsnphszhh
繫	hszhhhszspzznzznspn
繬	zznnnnhspnpnhszszhh
繭	hssszszznnnnszhshn
繮	zznnnnhszhshhszhshh
繯	zznnnnszsshhszhpzpn
繰	zznnnnszhszhszhhspn
繱	zznnnnhsspzppnnznn
繲	zznnnnpzpzhhszpphhs
繳	zznnnnpszhhnhzpphpn
繴	zhpszhnhnphhszznspn
繵	zznnnnnhszszhhszhhh
繶	zznnnnnhnphszhhnznn
繷	zznnnnszhsshhphhzpn
繸	zznnnnnphpzpppnnzn
繹	zznnnnszsshhshnphhs
繺	zznnnnpzzhhphpnnnnn
繻	zznnnnhnzsnnnnhpszss
繼	zznnnnzznzznhzznzznz
繽	zznnnnnnzhsppszhhhpn
繾	zznnnnszhshszhzhnzn
繿	zznnnnhszhszphnszssh
纀	zznnnnpsssnphnphhhpn
纁	zznnnnphsznphshhnnnn
纂	phnphnszhhhhpnzznspn
纃	zznnnnnhnpszppznpshh
纄	zznnnnhsspznhhhsnzn
纅	zznnnnpszhhzznzznhspn
纆	zznnnnsznphshhnnnnhsh
纇	nphspnzznspnhpszhhhpn
纈	zznnnnhshszhhpszhhhpn
纉	zznnnnhhpnhhpnszhhhpn
纊	zznnnnnhphsshszhshpn
纋	zznnnnhpszhhnznznnpzn
續	zznnnnhshszsshszhhhpn
纍	szhshszhshszhshzznspn
纎	zznnnnhshshhhshhhhzpn
纏	zznnnnnhpszhhshhpnhsh
纐	zznnnnnhpnpnhpszhhhpn
纑	zznnnnshzphzszhshszssh
纒	zznnnnhpszhhshhnnnnhsh
纓	zznnnnszhhhpnszhhhpnzph
纔	zznnnnpzszhhzpzpzszhpzn
纕	zznnnnnhszhszhhhsshpzpn
纖	zznnnnpnpnhshhhshhhhzpn
纗	zznnnnszspsnhhhshszpnszh
纘	zznnnnphshpzphshpzszhhhpn
纙	zznnnnszsshzznnnnpsnhhhsh
纚	zznnnnhsznhsznnhpzsshhzpz
纛	hhshzzshszhhhhspnpzznspn
纜	zznnnnhszhszphnszsshszhhhpz
纝	zznnnnszhshszhshszhshzznspn
纞	zznnnnnhhhszhzznnnnzznnnnnznn
纠	zzhzs
纡	zzhhhs
红	zzhhsh
纣	zzhhsn
纤	zzhphs
纥	zzhphz
约	zzhpzn
级	zzhpzn
纨	zzhpzn
纩	zzhnhp
纪	zzhzhz
纫	zzhzpn
纬	zzhhhzs
纭	zzhhhzn
纮	zzhhpzn
纯	zzhhzsz
纰	zzhhzpz
纱	zzhspnp
纲	zzhszpn
纳	zzhszpn
纴	zzhphsh
纵	zzhpnpn
纶	zzhpnpz
纷	zzhpnzp
纸	zzhpzhz
纹	zzhnhpn
纺	zzhnhzp
纻	zzhnnzh
纼	zzhzhzs
纽	zzhzshh
纾	zzhznzs
线	zzhhhzpn
绀	zzhhsshh
绁	zzhhsshz
绂	zzhhpznn
练	zzhhzzpn
组	zzhszhhh
绅	zzhszhhs
细	zzhszhsh
织	zzhszhpn
终	zzhpznnn
绉	zzhpzzhh
绊	zzhnphhs
绋	zzhzhzps
绌	zzhzsszs
绍	zzhzpszh
绎	zzhznhhs
经	zzhznhsh
绐	zzhznszh
绑	zzhhhhpzs
绒	zzhhhpzpn
结	zzhhshszh
绔	zzhhpnhhz
绕	zzhhzphpz
绖	zzhhznhsh
绗	zzhppshhs
绘	zzhpnhhzn
给	zzhpnhszh
绚	zzhpzszhh
绛	zzhpznhzs
络	zzhpznszh
绝	zzhpzzshz
绞	zzhnhpnpn
统	zzhnhznpz
绠	zzhhszhhpn
绡	zzhsnpszhh
绢	zzhszhszhh
绣	zzhphspnzp
绤	zzhpnpnszh
绥	zzhpnnpzph
绦	zzhpznhspn
继	zzhnphspnz
绨	zzhnpzhzsp
绩	zzhhhshszpn
绪	zzhhshpszhh
绫	zzhhshpnpzn
绬	zzhhssszhpn
续	zzhhsznnhpn
绮	zzhhpnhszhs
绯	zzhshhhshhh
绰	zzhshszhhhs
绱	zzhsnpszszh
绲	zzhszhhhzpz
绳	zzhszhszhhz
维	zzhpsnhhhsh
绵	zzhpszhhszs
绶	zzhpnnpnzzn
绷	zzhpzhhpzhh
绸	zzhpzhshszh
绹	zzhpzphhszs
绺	zzhpznsnszh
绻	zzhnphhpnzz
综	zzhnnzhhspn
绽	zzhnnzhshpn
绾	zzhnnzszhzh
绿	zzhzhhsnhpn
缀	zzhznznznzn
缁	zzhzzzszhsh
缂	zzhhsshszhhs
缃	zzhhspnszhhh
缄	zzhhphszhzpn
缅	zzhhpszsshhh
缆	zzhssphnszpz
缇	zzhszhhhshpn
缈	zzhszhhhspnp
缉	zzhszhhsshhh
缊	zzhszhhszssh
缋	zzhszhshszpn
缌	zzhszhshnznn
缍	zzhphshsshh
缎	zzhpshhhpzzn
缏	zzhpshszhhpn
缐	zzhpszhhszpn
缑	zzhpszhphhpn
缒	zzhpszhzhnzn
缓	zzhpnnphhpzn
缔	zzhnhnpnzszs
缕	zzhnphspnzph
编	zzhnzhpszhss
缗	zzhzhzhzszhh
缘	zzhzzhpzpppn
缙	zzhhssnphszhh
缚	zzhhszhhsnhsn
缛	zzhhphhzpnhsn
缜	zzhhsszhhhhpn
缝	zzhpznhhhsnzn
缞	zzhnhszhhpzpn
缟	zzhnhszhszszh
缠	zzhnhpszhhshh
缡	zzhnhpnzsszzn
缢	zzhnphpnszssh
缣	zzhnphzhhsspn
缤	zzhnnzpshshpn
缥	zzhhszsshhhspn
缦	zzhszhhszsshzn
缧	zzhszhshzznspn
缨	zzhszpnszpnzph
缩	zzhnnzpshpszhh
缪	zzhznhznhpnppp
缫	zzhzzzszhhhspn
缬	zzhhshszhhpszpn
缭	zzhhpnnpszhhspn
缮	zzhnphhhsnphszh
缯	zzhnpszsnphszhh
缰	zzhhszhshhszhshh
缱	zzhszhshszhzhnzn
缲	zzhszhszhszhhspn
缳	zzhszsshhszhpzpn
缴	zzhpszhhnhzpphpn
缵	zzhphshpzphshpzszpn
缶	phhszs
缷	phhszszs
缸	phhszshsh
缹	phhszsnnnn
缺	phhszszhpn
缻	zhhszshzzn
缼	phhszspzpn
缽	phhszshspnh
缾	phhszsnphhps
缿	phhszspphszh
罀	phhszspnhzpn
罁	phhszssznphszs
罂	szpnszpnphhszs
罃	nppnnppnnzphhszs
罄	hshzshppzznphhszs
罅	phhszsshzphzpnphs
罆	phhszszzshszhhhpn
罇	phhszsnphszpnhhhsn
罈	phhszshszsshszhhhs
罉	phhszssnpnzszhphhs
罊	hszhhhszspzznphhszs
罋	nhzzppsnhhhshphhszs
罌	szhhhpnszhhhpnphhszs
罍	szhshszhshszhshphhszs
罎	phhszsszhhhnzsnnnnhhzn
罏	phhszsshzphzszhshszssh
罐	phhszshssszhszhpsnhhhsh
网	szpnpn
罔	sznphnhz
罕	nzpnhhs
罖	szsshpnn
罗	szsshpzn
罘	szsshhpsn
罙	nzpnhspn
罚	szsshnzss
罛	szsshppznn
罜	szsshnhhsh
罝	szsshszhhh
罞	szsshznzsp
罟	szsshhsszh
罠	szsshzhzhz
罡	szsshhshsh
罢	szsshhshzn
罣	szsshhshhsh
罤	szsshnpzhzsp
罥	szsshszhszhh
罦	szsshpnnpzsh
罧	szsshhspnhspn
罨	szsshhpnszhhz
罩	szsshshszhhhs
罪	szsshshhhshhh
罫	szsshhshhshsn
罬	szsshznznznzn
罭	szsshhszhhzpn
置	szsshhsszhhhh
罯	szsshnhnphszhh
罰	szsshnhhhszhss
罱	szsshhssznphhs
署	szsshhshpszhh
罳	szsshszhshnznn
罴	szsshhshznnnnn
罵	szsshhshhsznnnn
罶	szsshpznzpszhsh
罷	szsshznszhhpzpz
罸	szsshnhhhszhhsn
罹	szsshnnspsnhhhsh
罺	szsshzzzszhhhspn
罻	szsshzhphhspnhsn
罼	szsshszhhhsshhs
罽	szsshhpnppnnppnss
罾	szsshnpszsnphszhh
罿	szsshnhnphszhhshh
羀	szpnpnhsshzzhszhsh
羁	szsshhsshszhhszzh
羂	szsshzznnnnszhszhh
羃	szsshhssszhhhpnszs
羄	szsshzznnnnshszhhhs
羅	szsshzznnnnpsnhhhsh
羆	szsshznszhhpzpznnnn
羇	szsshhsshszhhshpnhszhs
羈	szsshhsshszhhshshhsznnnn
羉	szsshnhhhszhzznnnnzznspn
羊	nphhhs
羌	nphhhpz
羍	hpnnphhhs
美	nphhshhpn
羏	nphhhpppp
羐	shshhshpzn
羑	nphhshpzn
羒	nphhhppnzp
羓	nphhhpzshz
羔	nphhshnnnn
羕	nphhshnzzpn
羖	nphhhppzzn
羗	nphhhpzzn
羘	pzhhnphhhs
羙	nphhshnppn
羚	nphhhppnnzn
羛	nphhshzhzps
羜	nphhhpnnzhs
羝	nphhhppzhzn
羞	nphhhpzshh
羟	nphhhpznhsh
羠	nphhhphzhzpn
羡	nphhshnhpzpn
羢	nphhhphhpzpn
羣	zhhpszhnphhhs
群	zhhpszhnphhhs
羥	nphhhphzzzhsh
羦	nphhhpnnzhhpz
羧	nphhhpznpnpzn
羨	nphhshnnhpzpn
義	nphhshphshzpn
羪	nphhhpnzhhzpn
羫	nphhhpnnzpnhsh
羬	nphhhphphszhzpn
羭	nphhhppnhszhhss
羮	nphhshnnnnhhhpn
羯	nphhhpszhhpzpnz
羰	nphhhpszshpnppn
羱	nphhhphppszhhspn
羲	nphhshphspnhzzpn
羳	nphhhppnphspnszhsh
羴	nphhhsnphhhpnphhhs
羵	nphhhphshssszhhhpn
羶	nphhhpnhszszhhszhhh
羷	nphhhppnhszhszhpnpn
羸	nhzszhpzhhnphhhspzn
羹	nphhshnnnnnphhshhpn
羺	nphhhphnzsnnnnhpszss
羻	nphhhpnhpzsshznznnpzn
羼	zhpnphhhsnphhhpnphhhs
羽	znhznh
羾	znhznhhsh
羿	znhznhhps
翀	znhznhszhs
翁	pnznznhznh
翂	znhznhpnzp
翃	hpznznhznh
翄	znhznhhszn
翅	hsznznhznh
翆	znhznhpzhs
翇	znhznhhpznn
翈	szhhsznhznh
翉	hspnhznhznh
翊	nhnphznhznh
翋	znhznhnhnph
翌	znhznhnhnph
翍	znhznhzpszn
翎	pnnznznhznh
翏	znhznhpnppp
翐	znhznhphhpn
翑	znhznhpzszh
習	znhznhpszhh
翓	hshszhznhznh
翔	nphhhpznhznh
翕	pnhszhznhznh
翖	pnhszhznhznh
翗	pznpzzznhznh
翘	hzphpzznhznh
翙	szspznznhznh
翚	znhznhnzhzhs
翛	psspznznhznh
翜	znhznhhpnpnpn
翝	nnzhpznznhznh
翞	znhznhnhszhspn
翟	znhznhpsnhhhsh
翠	znhznhnhpnpnhs
翡	shhhshhhznhznh
翢	pzhshszhznhznh
翣	znhznhnhnphzph
翤	szhszhssznhznh
翥	hshpszhhznhznh
翦	nphszhhssznhznh
翧	nnzhszhhhznhznh
翨	znhznhszhhhshpn
翩	nzhpszhssznhznh
翪	znhznhpnzspnpzn
翫	znhznhpszhhhhpz
翬	znhznhnzhszhhhs
翭	znhznhpszhphhpn
翮	hszhsznphsznhznh
翯	znhznhnhszhszszh
翰	hsszhhhspnznhznh
翱	pszhhhpnhsznhznh
翲	hszsshhhspnznhznh
翳	hphhpnzpzznznhznh
翴	znhznhhszhhhsnzn
翵	znhznhpszhhhznnnn
翶	pszhhnhpnhsznhznh
翷	nphspnpznhzsznhznh
翸	hshssszhhhpnznhznh
翹	hshhshhshhpzznhznh
翺	pszhhhnhpnhsznhznh
翻	pnphspnszhshznhznh
翼	znhznhszhshhsshpn
翽	shshhphsppzpnznhznh
翾	szsshhszhpzpnznhznh
翿	hshzhshhszhhsnznhznh
耀	snphpzznhznhpsnhhhsh
老	hshppz
考	hshphz
耄	hshppzphhz
者	hshpszhh
耆	hshppzszhh
耇	hshppzszh
耈	hshppzpzszh
耉	hshppzszh
耊	hshphznhsh
耋	hshppzhznhsh
而	hpszss
耍	hpszsszhp
耎	hpszsshpn
耏	hpszssppp
耐	hpszsshsn
耑	szshpszss
耒	hhhspn
耓	hhhspnhs
耔	hhhspnzsh
耕	hhhspnhhps
耖	hhhspnspnp
耗	hhhspnphhz
耘	hhhspnhhzn
耙	hhhspnzshz
耚	hhhspnzpszn
耛	hhhspnznszh
耜	hhhspnszhzh
耝	hhhspnszhhh
耞	hhhspnzpszh
耟	hhhspnhzhz
耠	hhhspnpnhszh
耡	hhhspnszhhhzp
耢	hhhspnhssnzzp
耣	hhhspnpnhszhss
耤	hhhspnhsshszhh
耥	hhhspnsnpszszh
耦	hhhspnszhhszshn
耧	hhhspnnphspnzph
耨	hhhspnhphhzpnhsn
耩	hhhspnhhsshszshh
耪	hhhspnnhnpnznhzp
耫	hhhspnhhshszhhhpn
耬	hhhspnszhhszhszph
耭	hhhspnzznzznhpnzpn
耮	hhhspnnppnnppnnzzp
耯	hhhspnhsspsnhhhshzn
耰	hhhspnhpszhhnznznnpzn
耱	hhhspnnhphspnhspnhpszh
耲	hhhspnnhszsshsnhpnpzpn
耳	hsshhh
耴	hsshhhz
耵	hsshhhhs
耶	hsshhhzs
耷	hpnhsshhh
耸	pnpnhsshhh
耹	hsshhhpnnz
耺	hsshhhhhzn
耻	hsshhhshsh
耼	hsshhhszhh
耽	hsshhhnzpz
耾	hsshhhhpzn
耿	hsshhhnppn
聀	hsshhhhzpz
聁	hsshhhpnzp
聂	hsshhhznzn
聃	hsshhhszshh
聄	hsshhhpnppp
聅	hsshhhphhpn
聆	hsshhhpnnzn
聇	hsshhhhshsh
聈	hsshhhzznzp
聉	hsshhhzsszs
聊	hsshhhpzpzs
聋	hpzpnhsshhh
职	hsshhhszhpn
聍	hsshhhnnzhs
聎	hsshhhpnhzpn
聏	hsshhhhpszss
聐	hsshhhhshszh
聑	hsshhhhsshhh
聒	hsshhhphsszh
聓	hshpznhsshhh
联	hsshhhnphhpn
聕	hsshhhphshszh
聖	hsshhhszhhhsh
聗	hsshhhhpnpnpn
聘	hsshhhszhshhz
聙	hsshhhhhshszhh
聚	hsshhhznpspppn
聛	hsshhhpszhhphs
聜	hsshhhnnzpnhsh
聝	hsshhhhszhhzpn
聞	szhhszhhhsshhh
聟	phhpnszhhsshhh
聠	hsshhhnphhps
聡	hsshhhpnznnznn
聢	hsshhhnnzhshpn
聣	hsshhhpshzhhpz
聤	hsshhhnhszhnzhs
聥	hsshhhpszhszshn
聦	hsshhhpzppnnznn
聧	hsshhhznppnhhpn
聨	hsshhhzznzznhps
聩	hsshhhszhshszpn
聪	hsshhhnpszhnznn
聫	hsshhhzznzznhpn
聬	hsshhhpnznznhznh
聭	hsshhhpszhhpzzn
聮	hsshhhzznzznnnnn
聯	hsshhhzznzznzpssh
聰	hsshhhpszpznhnznn
聱	hhshzpphpnhsshhh
聲	hshzshppzznhsshhh
聳	ppspnpnshpnhsshhh
聴	hsshhhhsszsshnznn
聵	hsshhhszhshszhhhpn
聶	hsshhhhsshhhhsshhh
職	hsshhhnhnphszhhzpn
聸	hsshhhpzhppnnhhhszh
聹	hsshhhnnznznnszsshhs
聺	hsshhhnnzpznnznhhspn
聻	nnhhszhhhspphshsshhh
聼	zhsshhhhsszsshhnznn
聽	hsshhhhhshhsszsshhnznn
聾	nhnphszhhshzhzhhhhsshhh
聿	zhhhhs
肁	nzhpzhhhhs
肂	hpznzhhhhs
肃	zhhspspn
肄	pzphhpnzhhhhs
肅	zhhspshhzzshs
肆	hshhhznzhhhhs
肇	nzhpphpnzhhhhs
肈	nzhphzpnzhhhhs
肉	szpnpn
肊	pzhhz
肋	pzhhzp
肌	pzhhpz
肍	pzhhpz
肎	nzszhh
肏	pnszpnpn
肐	pzhhphz
肑	pzhhpzn
肒	pzhhpzn
肓	nhzszhh
肔	pzhhzsz
肕	pzhhzpn
肖	snpszhh
肗	pzhhzph
肘	pzhhhsn
肙	szhszhh
肚	pzhhhsh
肛	pzhhhsh
肜	pzhhppp
肝	pzhhhhs
肞	pzhhnpn
肟	pzhhhhz
肠	pzhhzpp
股	pzhhpzzn
肢	pzhhhszn
肣	pzhhpnnz
肤	pzhhhhpn
肥	pzhhzshz
肦	pznhpnzp
肧	pzhhhpsn
肨	pzhhhhhs
肩	nzhpszhh
肪	pzhhnhzp
肫	pzhhhzsz
肬	pzhhhpzn
肭	pzhhszpn
肮	pzhhnhpz
肯	shshszhh
肰	pzhhhpnn
肱	pzhhhpzn
育	nhznszhh
肳	pzhhpzpp
肴	pnhpszhh
肵	pzhhpphs
肶	pzhhhzpz
肷	pzhhpzpn
肸	pzhhpnhs
肹	pzhhpnhz
肺	pzhhhszs
肻	shnzszhh
肼	pzhhhhps
肽	pzhhhpnn
肾	ssznszhh
肿	pzhhszhs
胀	pzhhphzn
胁	pzhhzpnn
胂	pzhhszhhs
胃	szhshszhh
胄	szhshszhh
胅	pzhhphhpn
胆	pzhhszhhh
胇	pzhhzhzps
胈	pzhhhpznn
胉	pzhhpszhh
胊	pznhpzszh
胋	pzhhshszh
背	shhpzszhh
胍	pzhhppznn
胎	pzhhznszh
胏	pzhhpzsp
胐	pznhzsszs
胑	pzhhszhpn
胒	pzhhzhppz
胓	pzhhhnphs
胔	shshpzszpnpn
胕	pzhhpshsn
胖	pzhhnphhs
胗	pzhhpnppp
胘	pzhhnhzzn
胙	pzhhphshh
胚	pzhhhpsnh
胛	pzhhszhhs
胜	pzhhphhsh
胝	pzhhpzhzn
胞	pzhhpzzhz
胟	pzhhzznhn
胠	pzhhhshzn
胡	hsszhpzhh
胢	pzhhhszhs
胣	pzhhphzsz
胤	pzznszhhz
胥	zshpnszhh
胦	pzhhszhpn
胧	pzhhhpzpn
胨	pzhhhzspn
胩	pzhhshhsn
胪	pzhhshzhp
胫	pzhhznhsh
胬	zphznszpnpn
胭	pzhhszhpnh
胮	pzhhpznhzs
胯	pzhhhpnhhz
胰	pzhhhzhzpn
胱	pzhhsnphpz
胲	pzhhnhzppn
胳	pzhhpznszh
胴	pzhhszhszh
胵	pzhhhznhsh
胶	pzhhnhpnpn
胷	pzpnzsszhh
胸	pzhhpzpnzs
胹	pzhhhpszss
胺	pzhhnnzzph
胻	pzhhppshhs
胼	pzhhnphhps
能	znszhhpzpz
胾	hshszpnpnzpn
胿	pzhhhshhsh
脀	zszpnhszhh
脁	pznhpnhzpn
脂	pzhhpzszhh
脃	pzhhpzzshz
脄	pzhhhpnppn
脅	zpzpzpszhh
脆	pzhhpzhpzz
脇	pzhhzpzpzp
脈	pzhhpppzpn
脉	pzhhnzzpn
脊	nhpnpnszhh
脋	zpzpzpszhh
脌	pzhhphhshs
脍	pzhhpnhhzn
脎	pzhhpnhspn
脏	pzhhnhphsh
脐	pzhhnhpnps
脑	pzhhnhpnzs
脒	pzhhnphspn
脓	pzhhnzpzpn
脔	nhsspnszpnpn
脕	pzhhpzszhpz
脖	pzhhhsnzzsh
脗	pzhhpzppszh
脘	pzhhnnzhhpz
脙	pzhhhsnhpnn
脚	pzhhhshznzs
脛	pzhhhzzzhsh
脜	pzhhhpszhhh
脝	pzhhnhszhzs
脞	pzhhpnpnhsh
脟	pzhhpnnphsn
脠	pzhhpshzzn
脡	pzhhphshzn
脢	pzhhphzznhn
脣	hphhzpnszhh
脤	pzhhhphhzpn
脥	pzhhhpnpnpn
脦	pzhhhnznnzn
脧	pznhznpnpzn
脨	pzhhhszhspn
脩	psspznszhh
脪	pzhhpnhpszs
脫	pzhhpnszhpz
脬	pzhhpnnpzsh
脭	pzhhszhhhsh
脮	pzhhpnnpzph
脯	pzhhhszhhsn
脰	pzhhhszhnph
脱	pzhhnpszhpz
脲	pzhhzhpszpn
脳	pzhhnnppnzs
脴	pzhhhpsnszh
脵	pzhhszhhhpn
脶	pzhhszhszpn
脷	pzhhphspnss
脸	pzhhpnhnnph
脹	pzhhhshhhzpn
脺	pzhhnhpnpnhs
脻	pzhhhzhhshpn
脼	pzhhhszspnpn
脽	pzhhpsnhhhsh
脾	pzhhpszhhphs
脿	pzhhhhshpzpn
腀	pzhhpnhszhss
腁	pzhhphhpphhs
腂	pzhhszhhhspn
腃	pzhhnphhpnzz
腄	pzhhphshsshh
腅	pzhhnppnnppn
腆	pzhhszhsshpn
腇	pzhhphspnzph
腈	pzhhhhshszhh
腉	pzhhpshzhhpz
腊	pzhhhsshszhh
腋	pzhhnhpspznn
腌	pzhhhpnszhhz
腍	pzhhpnnznznn
腎	hszhszznszhh
腏	pzhhznznznzn
腐	nhppshsnszpnpn
腑	pzhhnhppshsn
腒	pzhhzhphsszh
腓	pzhhshhhshhh
腔	pzhhnnzpnhsh
腕	pzhhnnzpznzz
腖	pzhhhszhhspn
腗	pzhhszhshhps
腘	pzhhszhhshnh
腙	pzhhnnzhhspn
腚	pzhhnnzhshpn
腛	pzhhzhphznhsh
腜	pzhhhsshhhspn
腝	pzhhhpszsshpn
腞	pzhhzzhpzpppn
腟	pzhhnnzhznhsh
腠	pzhhhhhpnhhpn
腡	pzhhszzszszh
腢	pzhhszhhszshn
腣	pzhhnhnpnzszs
腤	pzhhnhnphszhh
腥	pzhhszhhphhsh
腦	pzhhzzzpszpnh
腧	pzhhpnhszhhss
腨	pzhhszshpszss
腩	pzhhhssznphhs
腪	pzhhnzhszhhhs
腫	pzhhphszhhshh
腬	pzhhznzsphspn
腭	pzhhszhszhhhz
腮	pzhhszhshnznn
腯	pzhhpphsszhhh
腰	pzhhhszsshzph
腱	pzhhzhhhhszn
腲	pzhhszhshhzpn
腳	pzhhpnpnszhzs
腴	pzhhpshzhhpn
腵	pzhhzhshhzhzn
腶	pzhhpshhhpzzn
腷	pzhhhszhszhsh
腸	pzhhszhhhpzpp
腹	pzhhphszhhpzn
腺	pzhhpszhhszpn
腻	pzhhhhhszpnzn
腼	pzhhhpszsshhh
腽	pzhhszhhszssh
腾	pzhhnphhpnzzh
腿	pzhhzhhzpnnzn
膀	pzhhnhnpnznhzp
膁	pzhhnphzhhsspn
膂	nhzpphpzpnszhh
膃	pzhhszpnhszssh
膄	pzhhpshzhhszn
膅	pzhhnhpzhhsszh
膆	pzhhhhshzznspn
膇	pzhhpszhzhnzn
膈	pzhhhszhsznphs
膉	pzhhnphpnszssh
膊	pzhhhszhhsnhsn
膋	nppnnppnnzszhh
膌	pzhhnhpnpnszhh
膍	pzhhpszpnhhzpz
膎	pzhhpnnpzznhpn
膏	nhszhnzszhszhh
膐	nhzpphpzpnszpnpn
膑	pzhhnnzpshshpn
膒	pzhhhszhszhszhz
膓	pzhhphszhhhpzpp
膔	pzhhnhpzsshhzpz
膕	pzhhszhszhhzpnh
膖	pzhhpznhhhsnzn
膗	pzhhszspsnhhhsh
膘	pzhhhszsshhhspn
膙	pzhhzhzszhszhshn
膚	shzphzszhshszhh
膛	pzhhsnpnzszhhsh
膜	pzhhhssszhhhpn
膝	pzhhhspnpnsnhpn
膞	pzhhhszhhshnhsn
膟	pzhhnhzznnhpnhs
膠	pzhhznhznhpnppp
膡	pzhhnphhpnszhhh
膢	pzhhszhhszhszpn
膣	pzhhnnzpnhznhsh
膤	pzhhhnzsnnnnzhh
膥	hhspnhpzzpnszpnpn
膦	pzhhnphspnpznhzs
膧	pznhnhnphszhhshh
膨	pzhhhshszhnphppp
膩	pzhhhhhszhhhpnzn
膪	pzhhnhnpnzszsszh
膫	pzhhhpnnpszhhspn
膬	pzhhphhzphhzphhz
膭	pzhhszhshszhhhpn
膮	pzhhhshhshhshhpz
膯	pzhhznppnhszhnph
膰	pzhhpnphspnszhsh
膱	pzhhnhnphszhhzpn
膲	pzhhpsnhhhshnnnn
膳	pzhhnphhhsnphszh
膴	pzhhphhsssshnnnn
膵	pzhhhssnhpnpnhs
膶	pzhhszhhszhhhhsh
膷	pzhhzzpnzhhznzs
膸	pzhhhphshszhhnzn
膹	pzhhhshssszhhhpn
膺	nhppspsnhhhshszhh
膻	pzhhnhszszhhszhhh
膼	pzhhszzszszhnzn
膽	pzhhpzhppnnhhhszh
膾	pzhhpnhszsnphszhh
膿	pzhhszhsshhphhzpn
臀	zhphsshpnpzznszhh
臁	pzhhnhpnphzhhsspn
臂	zhpszhnhnphhsszhh
臃	pzhhnhzzppsnhhhsh
臄	pzhhshzphzhpzpppn
臅	pzhhszsshpzszhshn
臆	pzhhnhnphszhhnznn
臇	pzhhpsnhhhshszsz
臈	pzhhhssszhhpzpnz
臉	pzhhpnhszhszhpnpn
臊	pzhhszhszhszhhspn
臋	zhphsshpnpzznszpnpn
臌	pzhhhshszhnphhszn
臍	pzhhnhnpszppznpshh
臎	pzhhznhznhnhpnpnhs
臏	pzhhnnzhsppszhhhpn
臐	pzhhphsznphshhnnnn
臑	pzhhhnzsnnnnhpszss
臒	pzhhhsspsnhhhshzn
臓	pzhhhsshphszhszzpn
臔	pzhhhszhszznszhhhpn
臕	pzhhnhpzsshhzpznnnn
臖	pshhszhszhzhhhpnszhh
臗	pzhhnnzhssszhhhpzn
臘	pzhhzzzszpnhznnznnz
臙	pzhhhsshszhshhpznnnn
臚	pzhhshzphzszhshszssh
臛	pzhhhnzsnnnnpsnhhhsh
臜	pzhhphshpzphshpzszpn
臝	nhzszhpzhhszhhhspnpzn
臞	pzhhszhhhszhhhpsnhhhsh
臟	pzhhhsshpzhphszhszzpn
臠	nhhhszhzznnnnzznnnnszpnpn
臡	hsshszhhhpnpsnhhhshszpnpn
臢	pzhhphshpzphshpzszhhhpn
臣	hszhsz
臤	hszhszzn
臥	hszhszpn
臦	hshzsshhszhsz
臧	hpzhphszhszzpn
臨	hszhszphszhszhszh
臩	hshzsshhszhszhpnps
自	pszhhh
臫	pszhhhz
臬	pszhhhhspn
臭	pszhhhhpnn
臮	pszhhhpspnpn
臯	pszhhhnhpnhs
臰	pszhhhhpznpz
臱	pszhhhnnzpnnhzp
臲	pszhhhhspnpzhpzz
至	hznhsh
致	hznhshphpn
臵	hznhshpznszh
臶	hznhshhpszsh
臷	hshhznhshzpn
臸	hznhshhznhsh
臹	hznhshhpzzpn
臺	hshszhnzhznhsh
臻	hznhshhhhpnphspn
臼	pshzhh
臽	pzpshzhh
臾	pshzhhpn
臿	phspshzhh
舀	pnnppshzhh
舁	pshzhhhps
舂	hhhpnpshzhh
舃	pshzhhhznnnn
舄	pshzhhpznnnn
舅	pshzhhszhshzp
舆	pshhhzhszhhhpn
與	pshhhzszhhhpn
興	pshhszhszhzhhhpn
舉	pshhhzszhhhpnhhs
舊	hsspsnhhhshpshzhh
舋	pshhszhszhzhhnzszhhh
舌	phsszh
舍	pnhhsszh
舎	pnhshszh
舏	phsszhzs
舐	phsszhpzhz
舑	phsszhszshh
舒	pnhhsszhznzs
舓	phsszhszhhpzpp
舔	phsszhhhpnsnnn
舕	phsszhnppnnppn
舖	pnhhsszhhszhhsn
舗	pnhshszhhszhhsn
舘	pnhhsszhnnzszhzh
舙	phsszhphsszhphsszh
舚	phsszhpzhppnnhhhszh
舛	pznhzs
舜	pnnpnzpznhzs
舝	zshzzznzznhzs
舞	phhsssshpznhzs
舟	ppznhn
舠	ppznhnzp
舡	ppznhnhsh
舢	ppznhnszh
舣	ppznhnnpn
舤	ppznhnpzn
舥	ppznhnzshz
舦	ppznhnhpnn
舧	ppznhnppzn
舨	ppznhnppzn
舩	ppznhnpnzn
航	ppznhnnhpz
舫	ppznhnnhzp
般	ppznhnpzzn
舭	ppznhnhzpz
舮	ppznhnnzhp
舯	ppznhnszhs
舰	ppznhnszpz
舱	ppznhnpnzz
舲	ppznhnpnnzn
舳	ppznhnszhsh
舴	ppznhnphshh
舵	ppznhnnnzpz
舶	ppznhnpszhh
舷	ppznhnnhzzn
舸	ppznhnhszhs
船	ppznhnpzszh
舺	ppznhnszhhs
舻	ppznhnshzhp
舼	ppznhnhsshpn
舽	ppznhnpznhzs
舾	ppznhnhszpzh
舿	ppznhnhpnhhz
艀	ppznhnpnnpzsh
艁	ppznhnphshszh
艂	ppznhnpznhhhs
艃	ppznhnszhhshh
艄	ppznhnsnpszhh
艅	ppznhnpnhhspn
艆	ppznhnnzhhzpn
艇	ppznhnphshzn
艈	ppznhnnhznpsz
艉	ppznhnzhpphhz
艊	ppznhnpszhhszs
艋	ppznhnzshszssh
艌	ppznhnpnnznznn
艍	ppznhnzhphsszh
艎	ppznhnpszhhhhsh
艏	ppznhnnphpszhhh
艐	ppznhnpnzspnpzn
艑	ppznhnnzhpszhss
艒	ppznhnszhhszhhh
艓	ppznhnhsshzhspn
艔	ppznhnnhphsshzn
艕	ppznhnnhnpnznhzp
艖	ppznhnnphhhphsh
艗	ppznhnnphpnszssh
艘	ppznhnpshzhhszn
艙	ppznhnpnnzhhpszh
艚	ppznhnhszhsshszhh
艛	ppznhnszhhszhszph
艜	ppznhnhpsshznzszs
艝	ppznhnhnzsnnnnzhh
艞	ppznhnphnphnpnhzpn
艟	ppznhnnhnphszhhshh
艠	ppznhnznppnhszhnph
艡	ppznhnsnpnzszhszhsh
艢	ppznhnhspnpnhszszhh
艣	ppznhnshzphzszhshzp
艤	ppznhnnphhshphshzpn
艥	ppznhnszhhsshhhzpn
艦	ppznhnhszhszphnszssh
艧	ppznhnhsspsnhhhshzn
艨	ppznhnhssnzhhpzpppn
艩	ppznhnnhnpszppznpshh
艪	ppznhnpzszhshnnnnszhh
艫	ppznhnshzphzszhshszssh
艬	ppznhnpzszhhzpzpzszhpzn
艭	ppznhnpsnhhhshpsnhhhshzn
艮	zhhzpn
良	nzhhzpn
艰	znzhhzpn
艱	hsshszhhhpnzhhzpn
色	pzzshz
艳	hhhspzzshz
艴	zhzpspzzshz
艵	nphhpspzzshz
艶	szhsshhszhnphpzzshz
艷	hhhsshhhszshszhnphpzzshz
艺	hssz
艻	hsszp
艼	hsshs
艽	hsspz
艾	hsspn
艿	hsszp
芀	hsszp
芁	hsspz
节	hsszs
芃	hsspzn
芄	hsspzn
芅	hsshzn
芆	hssznn
芇	hssszs
芉	hsshhs
芊	hssphs
芋	hsshhs
芌	hsshhz
芍	hsspzn
芎	hsszhz
芏	hsshsh
芐	hsshsn
芑	hsszhz
芒	hssnhz
芓	hsszsh
芔	zsszspzss
芕	hsspzn
芖	hsshpn
芗	hsszzp
芘	hsshzpz
芙	hsshhpn
芚	hsshzsz
芛	hsszhhp
芜	hsshhpz
芝	hssnzn
芞	hssphhz
芟	hsspzzn
芠	hssnhpn
芡	hsspzpn
芢	hsspshh
芣	hsshpsn
芤	hsszshz
芥	hsspnps
芦	hssnzhp
芧	hssznzs
芨	hsspzn
芩	hsspnnz
芪	hsspzhz
芫	hsshhpz
芬	hsspnzp
芭	hsszshz
芮	hssszpn
芯	hssnznn
芰	hsshszn
花	hsspspz
芲	hsspnpz
芳	hssnhzp
芴	hsspzpp
芵	hsszhpn
芶	hsspzzn
芷	hssshsh
芸	hsshhzn
芹	hsspphs
芺	hssphpn
芻	pzzsppzzsp
芼	hssphhz
芽	hsshzsp
芾	hsshszs
芿	hsspszp
苀	hssnhpz
苁	hsspnpn
苂	hssnppn
苃	hsshpzn
苄	hssnhsn
苅	hsspnss
苆	hsshzzp
苇	hsshhzs
苈	hsshpzp
苉	hsshpzz
苊	hsshpzz
苋	hssszpz
苌	hssphzn
苍	hsspnzz
苎	hssnnzh
苏	hsszpnn
苐	hsszhzsp
苑	hsspznzz
苒	hssszshh
苓	hsspnnzn
苔	hssznszh
苕	hsszpszh
苖	hssszhsh
苗	hssszhsh
苘	hssszszh
苙	hssnhnph
苚	hsspzhhs
苛	hsshszhs
苜	hssszhhh
苝	hssshhpz
苞	hsspzzhz
苟	hsspzszh
苠	hsszhzhz
苡	hssznpn
苢	hssszhzh
苣	hsshzhz
苤	hsshpsnh
若	hsshpszh
苦	hsshsszh
苧	hssnnzhs
苨	hsszhppz
苩	hsspszhh
苪	hsshszpn
苫	hssshszh
苬	hssszpnh
苭	hsszznzp
苮	hsspsszs
苯	hsshspnh
苰	hsszhzzn
英	hssszhpn
苲	hssphshh
苳	hsspznnn
苴	hssszhhh
苵	hssphhpn
苶	hsspnspn
苷	hsshsshh
苸	hsspnphs
苹	hsshnphs
苺	hsszznhn
苻	hsspshsn
苼	hssphhsh
苽	hssppznn
苾	hssnznpn
苿	hsshhspn
茀	hsszhzps
茁	hsszsszs
茂	hsshpzpn
范	hssnnhzz
茄	hsszpszh
茅	hssznzsp
茆	hsspzpzs
茇	hsshpznn
茈	hssshshpz
茉	hsshhspn
茊	hsspshsh
茋	hsspzhzn
茌	hsspshsh
茍	shshpzszh
茎	hssznhsh
茏	hsshpzpn
茐	hsspzppn
茑	hsspznzh
茒	hsspznzs
茓	hssnnzpn
茔	hssnzhsh
茕	hssnzzhs
茖	hsspznszh
茗	hsspznszh
茘	hsszpzpzp
茙	hsshhpzpn
茚	hsspzhzs
茛	hsszhhzpn
茜	hsshszpzh
茝	hsshsszhsz
茞	hsshszhsz
茟	hsszhhhhs
茠	hsspshspn
茡	hssnnzzsh
茢	hsshpznss
茣	hssszhhhpn
茤	hsspznpzn
茥	hsshshhsh
茦	hsshszspn
茧	hssszhshn
茨	hssnhpzpn
茩	hsspphszh
茪	hsssnphpz
茫	hssnnhnhz
茬	hsshpshsh
茭	hssnhpnpn
茮	hssshhspn
茯	hsspshpnn
茰	hssszhhpn
茱	hssphhspn
茲	hsszznzzn
茳	hssnnhhsh
茴	hssszszhh
茵	hssszhpnh
茶	hsspnhspn
茷	hsspshzpn
茸	hsshsshhh
茹	hsszphszh
茺	hssnhznpz
茻	zspzsszspzss
茼	hssszhszh
茽	hsspsszhs
茾	hsshhps
茿	hsshshpzn
荀	hsspzszhh
荁	hsshszhhh
荂	hsshpnhhz
荃	hsspnhhsh
荄	hssnhzppn
荅	hsspnhszh
荆	hsshhpsss
荇	hssppshhs
荈	hsspznhzs
草	hssszhhhs
荊	hsshhpsss
荋	hsshpszss
荌	hssnnzzph
荍	hsszsphpn
荎	hsshznhsh
荏	hsspsphsh
荐	hsshpszsh
荑	hsshzhzpn
荒	hssnhzpsz
荓	hssnphhps
荔	hsszpzpzp
荕	hsspzhhzp
荖	hsshshppz
荗	hsshpnzpn
荘	hssnhshsh
荙	hsshpnnzn
荚	hsshnphpn
荛	hsshzphpz
荜	hsshzpzhs
荝	hssszpnss
荞	hssphpnps
荟	hsspnhhzn
荠	hssnhpnps
荡	hssnnhzpp
荢	hssnnzhhs
荣	hssnzhspn
荤	hssnzhzhs
荥	hssnzszpn
荦	hssnzphhs
荧	hssnznppn
荨	hsszhhhsn
荩	hsszhpnnn
荪	hsszshspn
荫	hsszspzhh
荬	hssznnhpn
荭	hsszzhhsh
荮	hsszzhhsn
药	hsszzhpzn
荰	hsshspnhsh
荱	hsszhpphhz
荲	hssszhhshh
荳	hsshszhnph
荴	hsshshhhpn
荵	hsszpnnznn
荶	hssszhpnnz
荷	hsspshszhs
荸	hsshsnzzsh
荹	hssshshspp
荺	hsshshpznh
荻	hsspzpnppn
荼	hsspnhhspn
荽	hsspnnpzph
荾	hssznpnpzn
荿	hsshpzzpn
莀	hsshphhzpn
莁	hsshspnpnh
莂	hssszhzpss
莃	hsspnhpszs
莄	hsshszhhpn
莅	hsspsnhnph
莆	hsshszhhsn
莇	hssszhhhzp
莈	hssnnhpzzn
莉	hssphspnss
莊	hsszshphsh
莋	hsspsphshh
莌	hssnpszhpz
莍	hsshsnhpnn
莎	hssnnhspnp
莏	hsshshspnp
莐	hssnnhnzpz
莑	hsspznhhhs
莒	hssszhszh
莓	hssphzznhn
莔	hssszpnszh
莕	hsshspnszh
莖	hsshzzzhsh
莗	hsshszhhhs
莘	hssnhnphhs
莙	hsszhhpszh
莚	hsspshzzn
莛	hssphshzn
莜	hsspssphpn
莝	hsspnpnhsh
莞	hssnnzhhpz
莟	hsspnnzszh
莠	hssphspnzp
莡	hssszhshpn
莢	hsshpnpnpn
莣	hssnhznznn
莤	hsshszpzhh
莥	hsspzpzshh
莦	hsssnpszhh
莧	hssszhhhpz
莨	hssnzhhzpn
莩	hsspnnpzsh
莪	hssphshzpn
莫	hssszhhhpn
莬	hsspzszhpz
莭	hsszhhznzs
莮	hssszhshzp
莯	hssnnhhspn
莰	hsshshpzpn
莱	hsshnphspn
莲	hsshzhsnzn
莳	hssszhhhsn
莴	hssszhszpn
莵	hsspszhpzn
莶	hsspnhnnph
获	hsspzphpnn
莸	hsspzphpzn
莹	hssnzhhshn
莺	hssnzpznzh
莻	hsszpszhpz
莼	hsszzhhzsz
莽	hsshpnnhps
莾	hsshpnhshps
莿	hsshszspnss
菀	hssnnzpznzz
菁	hsshhshszhh
菂	hsspszhhpzn
菃	hssnnhhzhz
菄	hsshszhhspn
菅	hssnnzszhzh
菆	hsshsshhhzn
菇	hsszphhsszh
菈	hsshshnhnph
菉	hsszhhsnhpn
菊	hsspznphspn
菋	hssszhhhspn
菌	hssszphspnh
菍	hsspnnznznn
菎	hssszhhhzpz
菏	hssnnhhszhs
菐	ssnphnphhhpn
菑	hsszzzszhsh
菒	hssszhhhspn
菓	hssszhhhspn
菔	hsspzhhzszn
菕	hsspzhszhss
菖	hssszhhszhh
菗	hsshshszhsh
菘	hsshspnpnzn
菙	hssphshsshh
菚	hsshzpnhzpn
菛	hssszhhszhh
菜	hsspnnphspn
菝	hsshshhpznn
菞	hssphspnpzp
菟	hsspzszhpzn
菠	hssnnhzpszn
菡	hsszsnhpnzs
菢	hsshshpzzhz
菣	hsshszhszzn
菤	hssnphhpnzz
菥	hsshspnpphs
菦	hsspphsnzn
菧	hssnhppzhzn
菨	hssnhnphzph
菩	hssnhnphszh
菪	hssnnzhpszh
菫	hsshszhhhsh
菬	hssnnhzpszh
菭	hssnnhznszh
菮	hssnhpzhhpn
華	hsshhsshhs
菰	hsszshppznn
菱	hsshshpnpzn
菲	hssshhhshhh
菳	hsspnhhsnph
菴	hsshpnszhhz
菵	hsssznphnhz
菶	hsshhhpnhhs
菷	hsszhhnzszs
菸	hssnhzppnnn
菹	hssnnhszhhh
菺	hssnzhpszhh
菻	hsshspnhspn
菼	hssnppnnppn
菽	hssshhspnzn
菾	hsshhpnsnnn
菿	hsshznhshss
萀	hssshzphzpz
萁	hsshsshhhpn
萂	hssphspnszh
萃	hssnhpnpnhs
萄	hsspzphhszs
萅	hsshzszszhh
萆	hsspszhhphs
萇	hsshshhhzpn
萈	hssszhhhpzn
萉	hsspzhhzshz
萊	hsshpnpnspn
萋	hsshzhhszph
萌	hssszhhpzhh
萍	hssnnhhnphs
萎	hssphspnzph
萏	hsspzphszhh
萐	hsshzhhshpn
萑	hsspsnhhhsh
萒	hssnhpnznpz
萓	hssnnzszhhh
萔	hsshshzpszh
萕	hssnhpnpshh
萖	hsspshzhhpz
萗	hssnnzhhspn
萘	hsshpnhhspn
萙	hsshspnnzpz
萚	hsshshznhhs
萛	hssszhhhhps
萜	hssszsshszh
萝	hssszsshpzn
萞	hssszpnhzpz
萟	hssphspnpzn
萠	hsspzhhpzhh
萡	hssnnhpszhh
萢	hssnnhpzzhz
萣	hssnnzhshpn
萤	hssnzszhshn
营	hssnzszhszh
萦	hssnzzznspn
萧	hsszhhspspn
萨	hsszsnhnphp
萩	hssphspnnppn
萪	hssphspnnnhs
萫	hssphspnszhh
萬	hssszhhszshn
萭	hsspszhszshn
萮	hsspnhszhhss
萯	hsspzszhhhpn
萰	hsshsznphspn
萱	hssnnzhszhhh
萲	hsspnnphhpzn
萳	hsshssznphhs
萴	hssszhhhpnss
萵	hssszzszszh
萶	hsshhhpnszhh
萷	hsssnpszhhss
萸	hsspshzhhpn
萹	hssnzhpszhss
萺	hssszhhszhhh
萻	hssnhnphszhh
萼	hssszhszhhhz
落	hssnnhpznszh
萾	hsszpznszssh
萿	hssnnhphsszh
葀	hsshshphsszh
葁	hssnphhshzph
葂	hsspzszhpzzp
葃	hssszhhphshh
葄	hsspzhhphshh
葅	hsspnpnszhhh
葆	hsspsszhhspn
葇	hssznzsphspn
葈	hssznszhhspn
葉	hsshsshzhspn
葊	hsspnhszhhps
葋	hsspzhhpzszh
葌	hsszphzphzph
葍	hsshszhszhsh
葎	hssppszhhhhs
葏	hssnnhzhhhhs
葐	hsspnzpszssh
葑	hsshshhshhsn
葒	hsszznnnnhsh
葓	hssnnhhsshpn
葔	hsspszhphhpn
葕	hssppsnnhhhs
葖	hssnnzpnhpnn
著	hsshshpszhh
葘	hsszzzhszhsh
葙	hsshspnszhhh
葚	hsshsshhhpnz
葛	hssszhhpzpnz
葜	hsshhhszphpn
葝	hsshzzzhshzp
葞	hsszhzhsshhh
葟	hsspszhhhhsh
葠	hsspszhhnzzn
葡	hsspzhszhhsn
葢	hsshpnnszssh
董	hssphszhhshh
葤	hsszznnnnhsn
葥	hssnphszhhss
葦	hsszshszhhzs
葧	hsshsnzzshzp
葨	hssszhshhzpn
葩	hsspszhhzshz
葪	hsspzpzhhsss
葫	hsshsszhpzhh
葬	hsshpznpzhps
葭	hsszhshhzhzn
葮	hsspshhhpzzn
葯	hsszznnnnpzn
葰	hsspsznpnpzn
葱	hsspzppnnznn
葲	hsspszhhszpn
葳	hsshphzphzpn
葴	hsshphszhzpn
葵	hssznppnhhpn
葶	hssnhszhnzhs
葷	hssnzhszhhhs
葸	hssszhshnznn
葹	hssnhzpphzsz
葺	hssszhhsshhh
葻	hsspzpszhshn
葼	hsspnzspnpzn
葽	hsshszsshzph
葾	hsspznzznznn
葿	hsszshpszhhh
蒀	hssszhhszssh
蒁	hsshspnnnzn
蒂	hssnhnpnzszs
蒃	hsszzhpzpppn
蒄	hssnzhhpzhsn
蒅	hssnnhpzhspn
蒆	hsshshpznzph
蒇	hsshpszpnzpn
蒈	hsshzpzpszhh
蒉	hssszhshszpn
蒊	hsspspzszhpz
蒋	hssnhspznhsn
蒌	hssnphspnzph
蒍	hssnpzzznnnn
蒎	hssnnhpppzpn
蒏	hssnzhszpzhh
蒐	hsspszhhpzzn
蒑	hssppzhhzpzzn
蒒	hsspszhzhhszs
蒓	hsszznnnnhzsz
蒔	hssszhhhshhsn
蒕	hssszpnhszssh
蒖	hsshsszhhhhpn
蒗	hssnnhnzhhzpn
蒘	hsszphszhphhs
蒙	hssnzhhpzpppn
蒚	hsshszhsznphs
蒛	hssphhszszhpn
蒜	hsshhspnhhspn
蒝	hsshppszhhspn
蒞	hssnnhpsnhnph
蒟	hssnhnphpzszh
蒠	hsspszhhhnznn
蒡	hssnhnpnznhzp
蒢	hsszspnhhspn
蒣	hssppspnhhspn
蒤	hssnnhpnhhspn
蒥	hsspznzpszhsh
蒦	hsspsnhhhshzn
蒧	hsshpshszhzpn
蒨	hsspshhshszhh
蒩	hssphspnszhhh
蒪	hsshszhhsnhsn
蒫	hssnphhhphsh
蒬	hssnzpzszhpzn
蒭	hsspzzsppzzsp
蒮	hssnzpszhhhsh
蒯	hsspzhhpzhhss
蒰	hssppznhnpzzn
蒱	hsshshhszhhsn
蒲	hssnnhhszhhsn
蒳	hsszznnnnszpn
蒴	hssnphzsppzhh
蒵	hsspnnpzznhpn
蒶	hsszznnnnpnzp
蒷	hssszhszhhhpn
蒸	hsszszpnhnnnn
蒹	hssnphzhhsspn
蒺	hssnhpnhphhpn
蒻	hsszhznhzhznh
蒼	hsspnnzhhpszh
蒽	hssszhpnhnznn
蒾	hssnphspnnzn
蒿	hssnhszhszszh
蓀	hsszshpzznspn
蓁	hsshhhpnphspn
蓂	hssnzszhhnhpn
蓃	hsspshzhhszn
蓄	hssnhzznszhsh
蓅	hssnnhnhznpsz
蓆	hssnhphsshszs
蓇	hssszznzszhh
蓈	hssnzhhznzs
蓉	hssnnzpnpnszh
蓊	hsspnznznhznh
蓋	hsshshznszssh
蓌	hsspnpnhshpzn
蓍	hsshshppzszhh
蓎	hssnhpzhhsszh
蓏	hssppznnppznn
蓐	hsshphhznphsn
蓑	hssnhszhhpzpn
蓒	hsshszhhhshhs
蓓	hsspsnhnphszh
蓔	hssnphhshnnnn
蓕	hsshspnhshhsh
蓖	hsspszpnhhzpz
蓗	hssppshshshpn
蓘	hssnhpnznpzpn
蓙	hssnhppnpnhsh
蓚	hsspsspznppp
蓛	hsshszspnphpn
蓜	hsshszpzhhzhz
蓝	hssssphnszssh
蓞	hsspnnppshzhh
蓟	hsspzszhshhss
蓠	hssnhpnzsszzn
蓡	hssnnhzhhnzzn
蓢	hssnzhhznpzhh
蓣	hssznzshpszpn
蓤	hssnhhshpnpzn
蓥	hssnzpnhhsnph
蓦	hssszhhhpnzzh
蓧	hsspsspznhspn
蓨	hsspsspznszhh
蓩	hssznzsppznzp
蓪	hssznszhhsnzn
蓫	hsshpzpppnnzn
蓬	hsspznhhhsnzn
蓭	hssnhphpnszhhz
蓮	hsshszhhhsnzn
蓯	hssppspnpnshpn
蓰	hssppsshshshpn
蓱	hssnnhnphhps
蓲	hsshszhszhszhz
蓳	hsshsshszhhhsh
蓴	hsshszhhshnhsn
蓵	hsshshhzhhshpn
蓶	hssszhpsnhhhsh
蓷	hsshshpsnhhhsh
蓸	hsshszhsshszhh
蓹	hssppsphhshshzs
蓺	hsshshpnhshpzn
蓻	hsshshnphhspzn
蓼	hssznhznhpnppp
蓽	hssszhhhsshhs
蓾	hssshszpnnnnnh
蓿	hssnnzpshpszhh
蔀	hssnhnphszhzs
蔁	hssnhnphszhhhs
蔂	hssszhshzznspn
蔃	hsszhzszhszhshn
蔄	hssszhhszhhszh
蔅	hssszhhszhhzph
蔆	hssnnhhshpnpzn
蔇	hsszhhznhzpz
蔈	hsshszsshhhspn
蔉	hssnhpnszhpzpn
蔊	hssnppnszhhhhs
蔋	hssnnhshhspnzn
蔌	hsshszhspnpzpn
蔍	hssnhpzsshhzpz
蔎	hssnhhhszhpzzn
蔏	hssnhnpszpnszh
蔐	hssnhnpszhsszh
蔑	hssszsshhpnzpn
蔒	hsszhhpszhnnnn
蔓	hssszhhszsshzn
蔔	hsspzhszhszhsh
蔕	hsshpsshznzszs
蔖	hssshzphzszhhh
蔗	hssnhphsshnnnn
蔘	hssznznznpnppp
蔙	hssnhzpphzshpn
蔚	hsszhphhspnhsn
蔛	hsspzpzhhsnnhs
蔜	hsshhshzpphpn
蔝	hssszhhhnphspn
蔞	hssszhhszhszph
蔟	hssnhzpphphhpn
蔠	hsszznnnnpznnn
蔡	hsspznnznhhspn
蔢	hssnnhzpsznzph
蔣	hsszshppznnhsn
蔤	hssnnznznpnszs
蔥	hsspszpznhnznn
蔦	hsspszhhhznnnn
蔧	hsshhhshhhszhh
蔨	hsssznphhpnzzh
蔩	hssnnzhszhshpn
蔪	hsshszhhhspphs
蔫	hsshshshhznnnn
蔬	hsszshshnhznpsz
蔭	hsszspnnzhhzn
蔮	hssszhszhhzpnh
蔯	hsszshszhhspn
蔰	hssnzhpszhzshz
蔱	hsspnhspnpzzn
蔲	hssnnzhhpzphpn
蔳	hssnnhhhshszhh
蔴	hssnhphspnhspn
蔵	hsshphszhszzpn
蔶	hsshhshszhhhpn
蔷	hsshsnphszszhh
蔸	hsspszhhpzzhpz
蔹	hsspnhnnphphpn
蔺	hssnszpsnhhhsh
蔻	hssnnzhhpzshzn
蔼	hssnzszhhpzpnz
蔽	hssnpszspnphpn
蔾	hssphspnpzphspn
蔿	hsspnnppzzznnnn
蕀	hsshszspnhszspn
蕁	hsszhhhshszhhsn
蕂	hsspzhhnphhpnzp
蕃	hsspnphspnszhsh
蕄	hssszhhszhhnznn
蕅	hssnnhszhhszshn
蕆	hsshpszhhhpnzpn
蕇	hssszhszhszhhhs
蕈	hsshszsshszhhhs
蕉	hsspsnhhhshnnnn
蕊	hssnznnnznnnznn
蕋	hssshshshshshsh
蕌	hssszhhszhhszhh
蕍	hssnnhpnhszhhss
蕎	hssphpnszhszszh
蕏	hsspzphshpszhh
蕐	hsshpnpnpnpnhhs
蕑	hssszhhszhhpzhh
蕒	hssszsshszhhhpn
蕓	hsshnzsnnnnhhzn
蕔	hsshshnphhszszn
蕕	hsspzpnphszpzhh
蕖	hssnnhhzhzhspn
蕗	hssszhshshpznszh
蕘	hsshshhshhshhpz
蕙	hsshszhhshnnznn
蕚	hssszhszhszhhhz
蕛	hssphspnnpzhzsp
蕜	hssshhhshhhnznn
蕝	hsszznnnnpzzshz
蕞	hssszhhhsshhhzn
蕟	hssznppnzhzpzzn
蕠	hsszphszhzznspn
蕡	hsshshssszhhhpn
蕢	hssszhshszhhhpn
蕣	hsspnnpnzpznhzs
蕤	hsshpzpppnphhsh
蕥	hsshzsppsnhhhsh
蕦	hssppphpszhhhpn
蕧	hssppsphszhhpzn
蕨	hsshpnphzsppzpn
蕩	hssnnhszhhhpzpp
蕪	hssphhsssshnnnn
蕫	hssnhnphszhhshh
蕬	hsszznnnnzznspn
蕭	hsszhhspshhzzshs
蕮	hsspshzhhpznnnn
蕯	hsszspznhphhsh
蕰	hssnnhszhhszssh
蕱	hssphspnsnpszhh
蕲	hssnpszhhhspphs
蕳	hssszhhszhhszhh
蕴	hsszzhszhhszssh
蕵	hsspznpnnzhhzpn
蕶	hsshnzsnnnnpnnzn
蕷	hssznzshpszhhhpn
蕸	hsszhshhzhznnzn
蕹	hssnhzzppsnhhhsh
蕺	hssszhhsshhhzpn
蕻	hsshshhhznhsshpn
蕼	hsshshhhznzhhhhs
蕽	hssszhsshhphhzpn
蕾	hsshnzsnnnnszhsh
蕿	hssnppnpnnphhpzn
薀	hssnnhszpnhszssh
薁	hsspsznphspnhpn
薂	hsspszhhnhzpphpn
薃	hssnnhnhszhszszh
薄	hssnnhhszhhsnhsn
薅	hsszphhphhzpnhsn
薆	hsspnnpnznznnpzn
薇	hssppsszshpzphpn
薈	hsspnhszsnphszhh
薉	hssshshhphsppzpn
薊	hsspzszhshnnnnss
薋	hssnhpzpnszhhhpn
薌	hsszzpnzhhznzs
薍	hsspnnpznszznznz
薎	hssszsshnzpshzpn
薏	hssnhnphszhhnznn
薐	hssphspnhshpnpzn
薑	hsshszhshhszhshh
薒	hssshpznznnphspn
薓	hssnnhzhhnzszszn
薔	hsshspnpnhszszhh
薕	hssnhpnphzhhsspn
薖	hssszzszszhnzn
薗	hssszhshszhpzpnh
薘	hsshshnphhhsnzn
薙	hssphhpnpsnhhhsh
薚	hsshpznszhhhpzpp
薛	hsspszhzhnhnphhs
薜	hsszhpszhnhnphhs
薝	hsspzhppnnhhhszh
薞	hsshpznpnnzhhzpn
薟	hsspnhszhszhpnpn
薠	hssnppnhpszhhhpn
薡	hssszhhhzhpshsz
薢	hsspzpzhhszpphhs
薣	hsshshszhnphhszn
薤	hsshpznshhhshhhh
薥	hssszsshpzszhshn
薦	hssnhpzsshhznnnn
薧	hssnhszhnzhpznpz
薨	hssszsshnzhpznpz
薩	hsszsnhnphpphhsh
薪	hssnhnphhspnpphs
薫	hssphszhhshhnnnn
薬	hsspszhhnhpnhspn
薭	hssphspnpszhhphs
薮	hssnphspnzphphpn
薯	hssszsshhshpszhh
薰	hssphsznphshhnnnn
薱	hssssnphnphhshhsn
薲	hssnnzhsppszhhhpn
薳	hsshshszhpspnnzn
薴	hssnnznznnszsshhs
薵	hsshshzhshhszhhsn
薶	hsspnnpzppszhhshh
薷	hsshnzsnnnnhpszss
薸	hssnnhhszsshhhspn
薹	hsshshszhnzhznhsh
薺	hssnhnpszppznhpshh
薻	hssnnhzzzszhhhspn
薼	hssnhpzsshhzpzhsh
薽	hsshszsshhshhzzn
薾	hsshpnszspnpnpnpn
薿	hsspzphhpnznzshpn
藀	hssnppnnppnnznppn
藁	hssnhszhszszhhspn
藂	hsshsshhhznpspppn
藃	hssnhszhszszhpzpn
藄	hsshsshhhpnzznspn
藅	hssszsshnhhhszhss
藆	hssnnzhhsshpnphhs
藇	hsspshhhzszhhhpn
藈	hssszhhhznppnhhpn
藉	hsshhhspnhsshszhh
藊	hssphspnnzhpszhss
藋	hssznhznhpsnhhhsh
藌	hssnnznznpnszhshn
藍	hsshszhszphnszssh
藎	hsszhhshnnnnszssh
藏	hsshpzhphszhszzpn
藐	hsspnnpzpppszhhpz
藑	hsspzszpnszhhhpzn
藒	hssphspnszhhpzpnz
藓	hsspzszhshhnphhhs
藔	hssnnzhpnnpszhhspn
藕	hsshhhspnszhhszshn
藖	hsshszhszznszhhhpn
藗	hsshszhspnpzpnnzn
藘	hssshzphzszhshnznn
藙	hssnhnphpzpppnpzzn
藚	hsshshszsshszhhhpn
藛	hssnnzpshzhhpznnnn
藜	hssphspnpzppnsnhpn
藝	hsshshpnhshpznhhzn
藞	hsshpszhhpszhhpszh
藟	hssszhshszhshszhsh
藠	hsspszhhpszhhpszhh
藡	hssnhnpszhsszhnzn
藢	hssppsszshhhshphpn
藣	hssszsshznszhhpzpz
藤	hsspzhhnphhpnsnhpn
藥	hsspszhhzznzznhspn
藦	hssnhphspnhspnphhs
藧	hsszznnnnpnnphhpzn
藨	hssnhpzsshhzpznnnn
藩	hssnnhpnphspnszhsh
藪	hssszhhszhszphphpn
藫	hssnnhhszsshszhhhs
藬	hsszsszhshszhhhpn
藭	hssnnzpnpszhhhpzhz
藮	hsshspnpsnhhhshnnnn
藯	hsszhphhspnhsnnznn
藰	hsspznzppnhhsnphss
藱	hssnhpnhpszhhpzzn
藲	hsshspnhszhszhszhz
藳	hssnhszhszszhphspn
藴	hsszznnnnszhhszssh
藵	hsspsszhhspnnhpzpn
藶	hsshpphspnphspnshsh
藷	hssnhhhszhhshpszhh
藸	hsshpzpppnhshpszhh
藹	hssnhhhszhszhhpzpnz
藺	hssszhhszhhpsnhhhsh
藻	hssnnhszhszhszhhspn
藼	hssnnzhhhsszsshnznn
藽	hssnhnphhspnszhhhpz
藾	hsshszhspnpzszhhhpn
藿	hsshnzsnnnnpsnhhhsh
蘀	hsshshszsshhshnphhs
蘁	hsshsszhszhhszhszhh
蘂	hssnznnnznnnznnhspn
蘃	hssshshshshshshhspn
蘄	hssszhszhszhhhspphs
蘅	hssppspzszhshhpnhhs
蘆	hssshzphzszhshszssh
蘇	hsspzszhshnnnnphspn
蘈	hssphspnpzhpszhhhpn
蘉	hssszsshnzpszhhnzzn
蘊	hsszznnnnszpnhszssh
蘋	hssshshspphpszhhhpn
蘌	hssppsphhshshzshhspn
蘍	hssphsznphshhnnnnzp
蘎	hsshnzsnnnnpzhhzshz
蘏	hsspzhhspnhpszhhhpn
蘐	hssnhhhszhpnnphhpzn
蘑	hssnhphspnhspnhpszh
蘒	hssphspnpzszhhszhhz
蘓	hssphspnpzszhshnnnn
蘔	hsspzphspnhpszhhhpn
蘕	hsszznnnnpznhhhsnzn
蘖	hsspszhzhnhnphhshspn
蘗	hsszhpszhnhnphhshspn
蘘	hssnhszhszhhhsshpzpn
蘙	hsshphhpnzpzznznhznh
蘚	hsspzszhshnnnnnphhhs
蘛	hsshsshhhpnznhznszhh
蘜	hsshsshszhhspznphspn
蘝	hsspnhszhszhpnpnpzpn
蘞	hsspnhszhszhpnpnphpn
蘟	hsszspnnphshzhhnznn
蘠	hsszshphspnpnhszszhh
蘡	hssszhhhpnszhhhpnzph
蘢	hssnhnphszhhshzhzhhh
蘣	hsshsshszhshpnnhhsh
蘤	hsspszhhpnnppzzznnnn
蘥	hsspnhszhszhszhszhss
蘦	hsshnzsnnnnszhszhszh
蘧	hssshzphzhpzpppnnzn
蘨	hsspnnpphhszspzznspn
蘩	hssphzznhnphpnzznspn
蘪	hssnhpzsshhzpznphspn
蘫	hssnnhhszhszphnszssh
蘬	hsspszhzhshshzhhnzszs
蘭	hssszhhszhhhsznphspn
蘮	hssszsshhpnppnnppnss
蘯	hssnnhszhhhpzppszssh
蘰	hsszznnnnszhhszsshzn
蘱	hssnphspnhpnnhpszhhhpn
蘲	hssszhshszhshszhshhsh
蘳	hsshsshszhshpnhshhsh
蘴	hsshhhsshhhszshszhnph
蘵	hsshsshhhnhnphszhhzpn
蘶	hssphspnzphpszhhpzzn
蘷	hsshpszhhshshzhzpnpzn
蘸	hsshszpzhhpsnhhhshnnnn
蘼	hssnhphspnhspnshhhshhh
虎	shzphzpz
虏	shzphzzp
虐	shzphzhzh
虑	shzphznznn
虒	ppshzphzpz
虓	pzshzphzpz
虔	shzphznhpn
處	shzphzpznpz
虖	shzphzpnphs
虗	shzphzpshsh
虘	shzphzszhhh
虙	shzphznznpn
虚	shzphzssnph
虛	shzphzsszshh
虫	szhshn
虬	szhshnz
虭	szhshnzp
虮	szhshnpz
虯	szhshnzs
虰	szhshnhs
虱	zpszhshn
虲	szhshnsn
虳	szhshnpzn
虴	szhshnphz
虵	szhshnzsz
虶	szhshnhhs
虷	szhshnhhs
虸	szhshnzsh
虹	szhshnhsh
虺	hpzszhshn
虻	szhshnnhz
虼	szhshnphz
虽	szhszhshn
虾	szhshnhsn
虿	hzpszhshn
蚀	pzzszhshn
蚁	szhshnnpn
蚂	szhshnzzh
蚃	zzpszhshn
蚄	szhshnnhzp
蚅	szhshnhpzz
蚆	szhshnzshz
蚇	szhshnzhpn
蚈	szhshnhhps
蚉	nhpnszhshn
蚊	szhshnnhpn
蚋	szhshnszpn
蚌	szhshnhhhs
蚍	szhshnhzpz
蚎	szhshnszhh
蚏	szhshnpzhh
蚐	szhshnpznh
蚑	szhshnhszn
蚒	szhshnpznh
蚓	szhshnzhzs
蚔	szhshnpzhz
蚕	hhpnszhshn
蚖	szhshnhhpz
蚗	szhshnzhpn
蚘	szhshnhpzn
蚙	szhshnpnnz
蚚	szhshnpphs
蚛	szhshnszhs
蚜	szhshnhzsp
蚝	szhshnphhz
蚞	szhshnhspn
蚟	szhshnhhsh
蚠	pnzpszhshn
蚡	szhshnpnzp
蚢	szhshnnhpz
蚣	szhshnpnzn
蚤	znnszhshn
蚥	szhshnpnpn
蚦	szhshnszhh
蚧	szhshnpnps
蚨	szhshnhhpn
蚩	zsshszhshn
蚪	szhshnnnhs
蚫	szhshnpzzhz
蚬	szhshnszpz
蚭	szhshnzhppz
蚮	szhshnpshzn
蚯	szhshnpshsh
蚰	szhshnszhsh
蚱	szhshnphshh
蚲	szhshnhnphs
蚳	szhshnpzhzn
蚴	szhshnzznzp
蚵	szhshnhszhs
蚶	szhshnhsshh
蚷	szhshnhzhz
蚸	szhshnpphsn
蚹	szhshnpshsn
蚺	szhshnszshh
蚻	hspnzszhshn
蚼	szhshnpzszh
蚽	szhshnhpsnh
蚾	szhshnzpszn
蚿	szhshnnhzzn
蛀	szhshnnhhsh
蛁	szhshnzpszh
蛂	szhshnhpznn
蛃	szhshnhszpn
蛄	szhshnhsszh
蛅	szhshnshszh
蛆	szhshnszhhh
蛇	szhshnnnzpz
蛈	szhshnphhpn
蛉	szhshnpnnzn
蛊	szhshnszssh
蛋	zshpnszhshn
蛌	szhshnppznn
蛍	nnpnzszhshn
蛎	szhshnhphzp
蛏	szhshnznhsh
蛐	szhshnszhssh
蛑	szhshnznphhs
蛒	szhshnpznszh
蛓	hshszhshnzpn
蛔	szhshnszszhh
蛕	szhshnhpszhh
蛖	szhshnhpzpppn
蛗	pszhzhszhshn
蛘	szhshnnphhhs
蛙	szhshnhshhsh
蛚	szhshnhpznss
蛛	szhshnphhspn
蛜	szhshnpszhhp
蛝	szhshnzhhzpn
蛞	szhshnphsszh
蛟	szhshnnhpnpn
蛠	szhshnzpzpzp
蛡	szhshnznhznh
蛢	szhshnnphhps
蛣	szhshnhshszh
蛤	szhshnpnhszh
蛥	szhshnpznpzn
蛦	szhshnhzhzpn
蛧	szhshnszpnpn
蛨	szhshnhpszhh
蛩	hshpznszhshn
蛪	hhhszpszhshn
蛫	szhshnpzhpzz
蛬	hsshpnszhshn
蛭	szhshnhznhsh
蛮	nhsspnszhshn
蛯	szhshnhshppz
蛰	hshpznszhshn
蛱	szhshnhnphpn
蛲	szhshnhzphpz
蛳	szhshnsphszs
蛴	szhshnnhpnps
蛵	szhshnhzzzhsh
蛶	szhshnpnnphsn
蛷	szhshnhsnhpnn
蛸	szhshnsnpszhh
蛹	szhshnznszhhs
蛺	szhshnhpnpnpn
蛻	szhshnpnszhpz
蛼	szhshnhszhhhs
蛽	szhshnszhhhpn
蛾	szhshnphshzpn
蛿	szhshnpnnzszh
蜀	szsshpzszhshn
蜁	szhshnphzshpn
蜂	szhshnpznhhhs
蜃	hphhzpnszhshn
蜄	szhshnhphhzpn
蜅	szhshnhszhhsn
蜆	szhshnszhhhpz
蜇	hshpphsszhshn
蜈	szhshnszhhhpn
蜉	szhshnpnnpzsh
蜊	szhshnphspnss
蜋	szhshnnzhhzpn
蜌	szhshnhzpzhsh
蜍	szhshnpnhhspn
蜎	szhshnszhszhh
蜏	szhshnphspnzp
蜐	szhshnhshznzp
蜑	pshzznszhshn
蜒	szhshnpshzzn
蜓	szhshnphshzn
蜔	szhshnpzszhsh
蜕	szhshnnpszhpz
蜖	szhshnszsshhh
蜗	szhshnszhszpn
蜘	szhshnphhpnszh
蜙	szhshnhspnpnzn
蜚	shhhshhhszhshn
蜛	szhshnzhphsszh
蜜	nnznznpnszhshn
蜝	hsshhhpnszhshn
蜞	szhshnhsshhhpn
蜟	szhshnnhznszhh
蜠	szhshnszphspnh
蜡	szhshnhsshszhh
蜢	szhshnzshszssh
蜣	szhshnnphhhpz
蜤	hspnpphsszhshn
蜥	szhshnhspnpphs
蜦	szhshnpnhszhss
蜧	szhshnnzhphpnn
蜨	szhshnhzhhshpn
蜩	szhshnpzhshszh
蜪	szhshnpzphhszs
蜫	szhshnszhhhzpz
蜬	szhshnzsnhpnzs
蜭	szhshnpzpshzhh
蜮	szhshnhszhhzpn
蜯	szhshnhhhpnhhs
蜰	pzhhzshzszhshn
蜱	szhshnpszhhphs
蜲	szhshnphspnzph
蜳	szhshnnhszhzsh
蜴	szhshnszhhpzpp
蜷	szhshnnphhpnzz
蜻	szhshnhhshszhh
蝈	szhshnszhhshnh
蝌	szhshnphspnnnhs
蝍	szhshnzhhznzs
蝗	szhshnpszhhhhsh
蝙	szhshnnzhpszhss
蝞	szhshnzshpszhhh
蝠	szhshnhszhszhsh
蝴	szhshnhsszhpzhh
螂	szhshnnzhhznzs
螌	ppznhnpzznszhshn
融	hszhsznphsszhshn
螛	szhshnnnzhhhsszh
螟	szhshnnzszhhnhpn
螨	szhshnhsshszpnpn
螯	hhshzpphpnszhshn
螲	szhshnnnzpnhznhsh
螳	szhshnsnpnzszhhsh
螸	pnpnszhpzpnszhshn
螺	szhshnszhshzznspn
蟀	szhshnnhzznnhpnhs
蟋	szhshnpnphspnnznn
蟏	szhshnhsszhhspspn
蟐	szhshnsnpnzszhszs
蟑	szhshnnhnphszhhhs
蟾	szhshnpzhppnnhhhszh
蠃	nhzszhpzhhszhshnpzn
血	pszssh
衅	pszsshnphhs
行	ppshhs
衍	ppsnnhhhs
街	ppshshhshhhs
御	ppsphhshshzs
衙	ppshszhszhhhs
衣	nhpzpn
补	nzspnsn
衦	nzspnhhs
衧	nzspnhhs
表	hhshpzpn
衩	nzspnznn
衪	nzspnzsz
衫	nzspnppp
衬	nzspnhsn
衭	nzspnhhpn
衮	nhpnznpzpn
衯	nzspnpnzp
衰	nhszhhpzpn
衱	nzspnpzn
衲	nzspnszpn
衳	nzspnpnzn
衴	nzspnnzpz
衵	nzspnszhh
衶	nzspnszhs
衷	nhszhspzpn
衸	nzspnpnps
衹	nzspnpzhz
衺	nhhzsppzpn
衻	nzspnszhh
衼	nzspnhszn
衽	nzspnphsh
衾	pnnznhpzpn
衿	nzspnpnnz
袀	nzspnpznh
袁	hshszhpzpn
袂	nzspnzhpn
袃	hzzpnhpzpn
袄	nzspnphpn
袅	pznznhpzpn
袆	nzspnhhzs
袇	nzspnpznh
袈	zpszhnhpzpn
袉	nzspnnnzpz
袊	nzspnpnnzn
袋	pshznnhpzpn
袌	nhpzzhzpzpn
袍	nzspnpzzhz
袎	nzspnzznzp
袏	nzspnhphsh
袐	nzspnnznpn
袑	nzspnzpszh
袒	nzspnszhhh
袓	nzspnszhhh
袔	nzspnhszhs
袕	nzspnnnzpn
袖	nzspnszhsh
袗	nzspnpnppp
袘	nzspnphzsz
袙	nzspnpszhh
袚	nzspnhpznn
袛	nzspnpzhzn
袜	nzspnhhspn
袝	nzspnpshsn
袞	nhpnszhpzpn
袟	nzspnphhpn
袠	nhphhpnpzpn
袡	nzspnszshh
袢	nzspnnphhs
袣	nzspnhsshz
袤	nhznzsppzpn
袥	nzspnhpszh
袦	nzspnzsszs
袧	nzspnpzszh
袨	nzspnnhzzn
袩	nzspnshszh
袪	nzspnhshzn
被	nzspnzpszn
袬	nhznszhpzpn
袭	hpzpnnhpzpn
袮	nzspnphspn
袯	nzspnzpznn
袱	nzspnpshpnn
袳	nzspnpznpzn
袴	nzspnhpnhhz
袵	nzspnpsphsh
袹	nzspnhpszhh
袺	nzspnhshszh
袻	nzspnhpszss
袼	nzspnpznszh
袽	nzspnzphszh
袾	nzspnphhspn
袿	nzspnhshhsh
裀	nzspnszhpnh
裁	hshnhpzpnzpn
裂	hpznssnhpzpn
裄	nzspnppshhs
装	nhshshnhpzpn
裆	nzspnsnpzhh
裇	nzspnpszssh
裈	nzspnnzhzhs
裉	nzspnzhhzpn
裊	pszhhhznhpzpn
裋	nzspnhszhnph
裌	nzspnhpnpnpn
裍	nzspnszhspnh
裎	nzspnszhhhsh
裏	nhszhhshhpzpn
裐	nzspnszhszhh
裓	nzspnhhpszpn
裔	nhpzpnszpnszh
裕	nzspnpnpnszh
裖	nzspnhphhzpn
裗	nzspnnhznpsz
裘	hsnhpnnnhpzpn
裙	nzspnzhhpszh
裚	hshpphsnhpzpn
裛	nhszhzshzpzpn
補	nzspnhszhhsn
裝	zshphshnhpzpn
裞	nzspnnpszhpz
裟	nnhspnpnhpzpn
裡	nzspnszhhshh
裢	nzspnhzhsnzn
裣	nzspnpnhnnph
裤	nzspnnhphzhs
裥	nzspnnszszhh
裨	nzspnpszhhphs
裩	nzspnszhhhzpz
裪	nzspnpzphhszs
裬	nzspnhshpnpzn
裭	nzspnshzphzpz
裮	nzspnszhhszhh
裯	nzspnpzhshszh
裰	nzspnznznznzn
裱	nzspnhhshpzpn
裳	snpnzszhnhpzpn
裴	shhhshhhnhpzpn
裵	nhshhhshhhpzpn
裶	nzspnshhhshhh
裷	nzspnnphhpnzz
裸	nzspnszhhhspn
裹	nhszhhhspnpzpn
裺	nzspnhpnszhhz
裻	shhspnznnhpzpn
裼	nzspnszhhpzpp
製	phhszsssnhpzpn
裾	nzspnzhphsszh
裿	nzspnhpnhszhs
褀	nzspnhsshhhpn
褂	nzspnhshhshsn
褃	nzspnshshszhh
褄	nzspnhzhhszph
褅	nzspnnhnpnzszs
褆	nzspnszhhhshpn
複	nzspnphszhhpzn
褉	nzspnhhhszphpn
褊	nzspnnzhpszhss
褋	nzspnhsshzhspn
褍	nzspnszshpszss
褐	nzspnszhhpzpnz
褒	nhpsszhhspnpzpn
褓	nzspnpsszhhspn
褔	nzspnhszhszhsh
褕	nzspnpnhszhhss
褖	nzspnzzhpzpppn
褗	nzspnhszhhzphz
褚	nzspnhshpszhh
褛	nzspnnphspnzph
褝	nzspnnnpszhhhs
褞	nzspnszhhszssh
褟	nzspnszhhznhznh
褡	nzspnhsspnhszh
褢	nhpszhhpzznpzpn
褥	nzspnhphhzpnhsn
褪	nzspnzhhzpnnzn
褬	nzspnznznznhspn
褰	nnzhhsshpnnhpzpn
褴	nzspnssphnszssh
褶	nzspnznhznhpszhh
褷	nzspnppsshshshpn
褽	zhphhspnhsnnhpzpn
褾	nzspnhszsshhhspn
褿	nzspnhszhsshszhh
襁	nzspnzhzszhszhshn
襄	nhszhszhhhsshpzpn
西	hszpzh
要	hszsshzph
覃	hszsshszhhhs
覆	hszsshppsphszhhpzn
见	szpz
观	znszpz
觃	szpzzsh
规	hhpnszpz
觅	pnnpszpz
视	nzsnszpz
觇	shszhszpz
览	ssphnszpz
觉	nnpnzszpz
觊	szszhzszpz
觋	hspnpnhszpz
觌	hsznnhpnszpz
觍	szhsshpnszpz
觎	pnhszhhssszpz
觏	hhsshszshhszpz
觐	hsshszhhhshszpz
觑	shzphzssnphszpz
角	pzpzhhs
觓	pzpzhhszs
觔	pzpzhhszp
觕	phshpzpzhhs
觖	pzpzhhszhpn
觗	pzpzhhspzhz
觘	pzpzhhsspnp
觙	pzpzhhspzn
觚	pzpzhhsppznn
觛	pzpzhhsszhhh
觜	shshpzpzpzhhs
觝	pzpzhhspzhzn
觞	pzpzhhsphzpp
觟	pzpzhhshshhsh
觠	nphhpnpzpzhhs
觡	pzpzhhspznszh
觢	hhhszppzpzhhs
解	pzpzhhszpphhs
觤	pzpzhhspzhpzz
觥	pzpzhhssnphpz
触	pzpzhhsszhshn
觧	pzpzhhsnphhhs
计	nzhs
订	nzhs
讣	nzsn
认	nzpn
讥	nzpz
讦	nzhhs
讧	nzhsh
讨	nzhsn
让	nzshh
讪	nzszs
讫	nzphz
讬	nzphz
训	nzpss
议	nznpn
讯	nzzhs
记	nzzhz
讱	nzzpn
讲	nzhhps
讳	nzhhzs
讴	nzhpnz
讵	nzhzhz
讶	nzhzsp
讷	nzszpn
许	nzphhs
讹	nzpspz
论	nzpnpz
讻	nzpnzs
讼	nzpnzn
讽	nzpzpn
设	nzpzzn
访	nznhzp
诀	nzzhpn
证	nzhshsh
诂	nzhsszh
诃	nzhszhs
评	nzhnphs
诅	nzszhhh
识	nzszhpn
诇	nzszszh
诈	nzphshh
诉	nzpphsn
诊	nzpnppp
诋	nzpzhzn
诌	nzpzzhh
词	nzzhszh
诎	nzzsszs
诏	nzzpszh
诐	nzzpszn
译	nzznhhs
诒	nzznszh
诓	nzhhhshz
试	nzhhshzn
诖	nzhshhsh
诗	nzhshhsn
诘	nzhshszh
诙	nzhpnppn
诚	nzhpzzpn
诛	nzphhspn
诜	nzphshpz
话	nzphsszh
诞	nzpshzzn
诟	nzpphszh
诠	nzpnhhsh
诡	nzpzhpzz
询	nzpzszhh
诣	nzpzszhh
诤	nzpzzhhs
该	nznhzppn
详	nznphhhs
诧	nznnzphz
诨	nznzhzhs
诩	nzznhznh
诪	nzhhhphsn
诫	nzhhpszpn
诬	nzhspnpnh
语	nzhszhszh
诮	nzsnpszhh
误	nzszhhhpn
诰	nzphshszh
诱	nzphspnzp
诲	nzphzznhn
诳	nzpzphhsh
说	nznpszhpz
诵	nzznszhhs
诶	nzznphhpn
请	nzhhshszhh
诸	nzhshpszhh
诺	nzhsshpszh
读	nzhsznnhpn
诽	nzshhhshhh
课	nzszhhhspn
诿	nzphspnzph
谀	nzphszhhpn
谁	nzpsnhhhsh
调	nzpzhshszh
谄	nzpzpshzhh
谆	nznhszhzsh
谈	nznppnnppn
谊	nznnzszhhh
谋	nzhsshhhspn
谌	nzhsshhhpnz
谍	nzhsshzhspn
谎	nzhssnhzpsz
谏	nzhsznphspn
谐	nzhzpzpszhh
谒	nzszhhpzpnz
谓	nzszhshszhh
谔	nzszhszhhhz
谕	nzpnhszhhss
谖	nzpnnphhpzn
谗	nzpzszhpznn
谘	nznhpzpnszh
谙	nznhnphszhh
谚	nznhnphpppp
谛	nznhnpnzszs
谜	nznphspnnzn
谢	nzpszhhhphsn
谣	nzpnnpphhszs
谤	nznhnpnznhzp
谥	nznphpnszssh
谦	nznphzhhsspn
谨	nzhsshszhhhsh
谩	nzszhhszsshzn
谪	nznhnpszhsszh
谬	nzznhznhpnppp
谭	nzhszsshszhhhs
谰	nznszhsznphspn
谱	nznphssnphszhh
谲	nzznzspszpnszh
谴	nzszhshszhzhnzn
谷	pnpnszh
豁	nnzhhhsszhpnpnszh
豆	hszhnph
豇	hszhnphhsh
豉	hszhnphhszn
豌	hszhnphnnzpznzz
豐	hhhsshhhszshszhnph
豕	hpzpppn
豖	hpzppnpn
豚	pzhhhpzpppn
象	pzszhpzpppn
豢	nphhpnhpzpppn
豹	pnnpzpppzn
豺	pnnpzpphsp
贝	szpn
贞	shszpn
负	pzszpn
贡	hshszpn
财	szpnhsp
责	hhshszpn
贤	ssznszpn
败	szpnphpn
账	szpnphzn
货	pspzszpn
质	pphsszpn
贩	szpnppzn
贪	pnnzszpn
贫	pnzpszpn
贬	szpnpnzn
购	szpnpzzn
贮	szpnnnzh
贯	zzshszpn
贰	hhhszpnzn
贱	szpnhhzpn
贲	hshssszpn
贴	szpnshszh
贵	szhshszpn
贷	pshznszpn
贸	pznzpszpn
费	zhzpsszpn
贺	zpszhszpn
贻	szpnznszh
贼	szpnhhpzpn
贾	hszsshszpn
贿	szpnhpszhh
赀	shshpzszpn
赁	psphshszpn
赂	szpnpznszh
赃	szpnnhphsh
资	nhpzpnszpn
赅	szpnnhzppn
赈	szpnhphhzpn
赊	szpnpnhhspn
赋	szpnhhshshzn
赌	szpnhshpszhh
赎	szpnhsznnhpn
赏	snpnzszhszpn
赐	szpnszhhpzpp
赓	nhpzhhpnszpn
赔	szpnnhnphszh
赖	hszhspnpzszpn
赘	hhshzpphpnszpn
赙	szpnhszhhsnhsn
赚	szpnnphzhhsspn
赛	nnzhhsshpnszpn
赝	hppspsnhhhshszpn
赞	phshpzphshpzszpn
赠	szpnnpszsnphszhh
赡	szpnpzhppnnhhhszh
赢	nhzszhpzhhszpnpzn
赣	nhnphszhhhspznhshszpn
赤	hshpspn
赥	hshpspnpzpn
赦	hshpspnphpn
郝	hshpspnzs
赫	hshpspnhshpspn
赭	hshpspnhshpszhh
走	hshshpn
赳	hshshpnzs
赴	hshshpnsn
赵	hshshpnpn
赶	hshshpnhhs
起	hshshpnzhz
趟	hshshpnsnpszszh
趣	hshshpnhsshhhzn
足	szhshpn
趴	szhshshpn
趸	hzpszhshpn
趼	szhshshhhps
趾	szhshshshsh
跃	szhshshphpn
跆	szhshshznszh
跌	szhshshphhpn
跎	szhshshnnzpz
跑	szhshshpzzhz
跚	szhshshpzpzh
跛	szhshshzpszn
跟	szhshshzhhzpn
跩	szhshshszhhzp
跪	szhshshpzhpzz
路	szhshshpznszh
跰	szhshshnphhps
跳	szhshshpnhzpn
践	szhshshhhzpn
跷	szhshshhzphpz
跹	szhshshphsnzn
跺	szhshshpzhspn
跻	szhshshnhpnps
跼	szhshshzhpzszh
跾	pssphpnszhshpn
踂	szhshshhsshhhz
踃	szhshshsnpszhh
踄	szhshshshshspp
踅	hshpphsszhshpn
踆	szhshshznpnpzn
踊	szhshshznszhhs
踏	szhshshszpnszhh
踐	szhshshhzpnhzpn
踖	szhshshhsshszhh
踘	szhshshpznphspn
踜	szhshshhshpnpzn
踝	szhshshszhhhspn
踠	szhshshnnzpznzz
踢	szhshshszhhpzpp
踣	szhshshnhnphszh
踩	szhshshpnnphspn
踪	szhshshnnzhhspn
踫	szhshshnphssnph
踱	szhshshnhphsshzn
踹	szhshshszshpszss
踺	szhshshzhhhhszn
踿	szhshshphspnnppn
蹀	szhshshhsshzhspn
蹄	szhshshnhnpnzszs
蹇	nnzhhsshpnszhshpn
蹈	szhshshpnnppshzhh
蹉	szhshshnphhhphsh
蹋	szhshshszhhznhznh
蹍	szhshshzhphsshzpn
蹑	szhshshhsshhhznzn
蹒	szhshshhsshszpnpn
蹓	szhshshpznzpszhsh
蹗	szhshshnhpzsshhzpz
蹙	hpshhspnzpnszhshpn
蹚	szhshshsnpnzszhhsh
蹝	szhshshppsshshshpn
蹡	szhshshzshppznnhsn
蹦	szhshshszspzhhpzhh
蹧	szhshshhszhsshszhh
蹩	npszspnphpnszhshpn
蹬	szhshshznppnhszhnph
蹭	szhshshnpszsnphszhh
蹲	szhshshnphszpzhhhsn
蹴	szhshshnhszhspnhpzn
蹵	nhszhspnhpznszhshpn
蹶	szhshshhpnphzsppzpn
蹾	szhshshnhszhzshphpn
蹿	szhshshnnzpnszhszhs
躁	szhshshszhszhszhhspn
躃	szhshshzhpszhnhnphhs
躄	zhpszhnhnphhsszhshpn
躈	szhshshpszhhnhzpphpn
躍	szhshshznhznhpsnhhhsh
躟	szhshshnhszhszhhhsshpzpn
躡	szhshshhsshhhhsshhhhsshhh
躣	szhshshszhhhszhhhpsnhhhsh
躩	szhshshszhhhszhhhpsnhhhshzn
身	pszhhhp
躬	pszhhhpzhz
躯	pszhhhphpnz
躲	pszhhhppzhspn
躺	pszhhhpsnpszszh
躻	pszhhhpnnzpnhsh
车	hzhs
轧	hzshz
轨	hzshpz
轩	hzshhhs
轪	hzshhpn
轫	hzshzpn
转	hzshhhzn
轭	hzshhpzz
轮	hzshpnpz
软	hzshpzpn
轰	hzhsznzn
轱	hzshhsszh
轳	hzshshzhp
轴	hzshszhsh
轶	hzshphhpn
轻	hzshznhsh
轼	hzshhhshzn
载	hshhzshzpn
轿	hzshphpnps
辁	hzshpnhhsh
较	hzshnhpnpn
辄	hzshhsshhhz
辅	hzshhszhhsn
辆	hzshhszpnpn
辈	shhhshhhhzhs
辉	snphpznzhzhs
辊	hzshszhhhzpz
辍	hzshznznznzn
辎	hzshzzzszhsh
辏	hzshhhhpnhhpn
辐	hzshhszhszhsh
辑	hzshszhhsshhh
输	hzshpnhszhhss
辕	hzshhshszhpzpn
辗	hzshzhphsshzpn
辘	hzshnhpzsshhzpz
辙	hzshnhznszhhphpn
辚	hzshnphspnpznhzs
辛	nhnphhs
辜	hsszhnhnphhs
辞	phsszhnhnphhs
辟	zhpszhnhnphhs
辠	pszhhhnhnphhs
辣	nhnphhphszhspn
辧	nhnphhpzpnhnphhs
辨	nhnphhpnpnhnphhs
辩	nhnphhpnznhnphhs
辫	nhnphhpzzhnhnphhs
辰	hphhzpn
辱	hphhzpnhsn
边	zpnzn
辽	zsnzn
达	hpnnzn
迁	phsnzn
迂	hhsnzn
迃	hhznzn
迅	zhsnzn
过	hsnnzn
迈	hzpnzn
迉	zhpnzn
迋	hhshnzn
迎	pzzsnzn
运	hhznnzn
迓	hzspnzn
返	ppznnzn
还	hpsnnzn
这	nhpnnzn
迚	szhsnzn
进	hhpsnzn
远	hhpznzn
违	hhzsnzn
连	hzhsnzn
迟	zhpnnzn
迠	shszhnzn
迢	zpszhnzn
迪	szhshnzn
迫	pszhhnzn
迭	phhpnnzn
述	hspnnnzn
迳	znhshnzn
迷	nphspnnzn
迸	nphhpsnzn
迹	nhpspnnzn
追	pszhzhnzn
迿	pzszhhnzn
退	zhhzpnnzn
送	nphhpnnzn
适	phsszhnzn
逃	pnhzpnnzn
逅	pphszhnzn
逆	nphzspnzn
选	phshpznzn
逊	zshspnnzn
逋	hszhhsnnzn
逍	snpszhhnzn
透	phspnzpnzn
逐	hpzpppnnzn
递	npzhzspnzn
途	pnhhspnnzn
逗	hszhnphnzn
逘	znphhpnnzn
通	znszhhsnzn
逛	pzphhshnzn
逝	hshpphsnzn
逞	szhhhshnzn
速	hszhspnnzn
造	phshszhnzn
逡	znpnpznnzn
逢	pznhhhsnzn
逮	zhhsnhpnnzn
逵	hshpnhshnzn
逶	phspnzphnzn
逸	pzszhpznnzn
逻	szsshpznnzn
逼	hszhszhshnzn
逾	pnhszhhssnzn
遁	pphsszhhhnzn
遂	nphpzpppnnzn
遇	szhhszshnnzn
遊	nhzpphzshnzn
遍	nzhpszhssnzn
遏	szhhpzpnznzn
遐	zhshhzhznnzn
遑	pszhhhhshnzn
道	nphpszhhhnzn
遗	szhshszpnnzn
遙	pznnphhszsnzn
遚	pshzhhsznnzn
遜	zshpzznspnnzn
遡	nphzsppzhhnzn
遢	szhhznhznhnzn
遣	szhshszhzhnzn
遥	pnnpphhszsnzn
遨	hhshzpphpnnzn
適	nhnpszhsszhnzn
遭	hszhsshszhhnzn
遮	nhphsshnnnnnzn
遵	nphszpzhhhsnnzn
遺	szhshszhhhpnnzn
遼	hpnnpszhhspnnzn
避	zhpszhnhnphhsnzn
邀	pszhhnhzpphpnnzn
邂	pzpzhhszpphhsnzn
邃	nnzpnnphpzpppnnzn
邆	znppnhszhnphnzn
邋	zzzszpnhznnznnznzn
邑	szhzshz
邒	hszs
邓	znzs
邔	zhzzs
邕	zzzszhzshz
邖	szszs
邗	hhszs
邘	hhszs
邙	nhzzs
邝	nhpzs
邢	hhpszs
那	zhhpzs
邤	pphszs
邦	hhhpzs
邨	hzszzs
邪	hzspzs
邬	pzzhzs
邮	szhshzs
邯	hsshhzs
邱	pshshzs
邳	hpsnhzs
邵	zpszhzs
邸	pzhznzs
邹	pzzhhzs
邺	ssnphzs
邻	pnnznzs
郂	nhzppnzs
郅	hznhshzs
郊	nhpnpnzs
郎	nzhhznzs
郑	nphhpnzs
郙	hszhhsnzs
郜	phshszhzs
郝	hshpspnzs
郞	nzhhzpnzs
郡	zhhpszhzs
郧	szhszpnzs
部	nhnphszhzs
郩	pnhpszhhzs
郫	pszhhphszs
郭	nhszhzshzs
郳	pshzhhpzzs
郴	hspnhspnzs
郸	npszhhhszs
都	hshpszhhzs
郾	hszhhzphzzs
鄂	szhszhhhzzs
鄃	pnhszhhsszs
鄅	pszhszshnzs
鄇	pszhphhpnzs
鄘	nhpzhhszhhszs
鄙	szhhsszszhhzs
鄝	znhznhpnpppzs
鄰	nphspnpznhzszs
酄	hssszhszhpsnhhhshzs
酈	hsznhsznnhpzsshhzpzzs
酉	hszpzhh
酋	nphszpzhh
酌	hszpzhhpzn
配	hszpzhhzhz
酒	nnhhszpzhh
酗	hszpzhhpnzs
酚	hszpzhhpnzp
酝	hszpzhhhhzn
酥	hszpzhhphspn
酯	hszpzhhpzszhh
酱	nhspznhszpzhh
酵	hszpzhhhshpzsh
酶	hszpzhhphzznhn
酸	hszpzhhznpnpzn
醂	hszpzhhhspnhspn
醇	hszpzhhnhszhzsh
醉	hszpzhhnhpnpnhs
醋	hszpzhhhsshszhh
醒	hszpzhhszhhphhsh
醚	hszpzhhnphspnnzn
醛	hszpzhhhsspnhhsh
釀	hszpzhhnhszhszhhhsshpzpn
采	pnnphspn
釉	pnphspnszhsh
释	pnphspnznhhs
里	szhhshh
重	phszhhshh
野	szhhshhznzs
量	szhhhszhhshh
釐	hhspnphpnhpszhhshh
金	pnhhsnph
釡	pnpnhhsnph
钆	phhhzz
针	phhhzhs
钉	phhhzhs
钊	phhhzss
钋	phhhzsn
钍	phhhzhsh
钎	phhhzphs
钏	phhhzpss
钒	phhhzpzn
钓	phhhzpzn
钗	phhhzznn
钘	phhhzhhps
钙	phhhzhshz
钚	phhhzhpsn
钛	phhhzhpnn
钝	phhhzhzsz
钟	phhhzszhs
钠	phhhzszpn
钡	phhhzszpn
钢	phhhzszpn
钣	phhhzppzn
钤	phhhzpnnz
钥	phhhzpzhh
钧	phhhzpznh
钩	phhhzpzzn
钮	phhhzzshh
钯	phhhzzshz
钱	phhhzhhzpn
钳	phhhzhsshh
钴	phhhzhsszh
钵	phhhzhspnh
钶	phhhzhszhs
钻	phhhzshszh
钾	phhhzszhhs
钿	phhhzszhsh
铀	phhhzszhsh
铁	phhhzphhpn
铂	phhhzpszhh
铃	phhhzpnnzn
铄	phhhzpzspn
铅	phhhzpzszh
铆	phhhzpzpzh
铉	phhhznhzzn
铍	phhhzzpszn
铐	phhhzhshphz
铒	phhhzhsshhh
铙	phhhzhzphpz
铜	phhhzszhszh
铝	phhhzszhszh
铠	phhhzszszhz
铡	phhhzszpnss
铭	phhhzpznszh
铮	phhhzpzzhhs
铲	phhhznhnphp
银	phhhzzhhzpn
铸	phhhzhhhphsn
铺	phhhzhszhhsn
链	phhhzhzhsnzn
铿	phhhzssznhsh
销	phhhzsnpszhh
锁	phhhzsnpszpn
锃	phhhzszhhhsh
锄	phhhzszhhhzp
锅	phhhzszhszpn
锆	phhhzphshszh
锈	phhhzphspnzp
锉	phhhzpnpnhsh
锋	phhhzpznhhhs
锍	phhhznhznpsz
锐	phhhznpszhpz
锔	phhhzzhpzszh
锗	phhhzhshpszhh
错	phhhzhsshszhh
锞	phhhzszhhhspn
锟	phhhzszhhhzpz
锡	phhhzszhhpzpp
锢	phhhzszhsszhh
锣	phhhzszsshpzn
锤	phhhzphshsshh
锦	phhhzpszhhszs
锨	phhhzpphspzpn
锫	phhhznhnphszh
锭	phhhznnzhshpn
键	phhhzzhhhhszn
锯	phhhzzhphsszh
锰	phhhzzshszssh
锲	phhhzhhhszphpn
锵	phhhznhspznhsn
锶	phhhzszhshnznn
锷	phhhzszhszhhhz
锹	phhhzphspnnppn
锻	phhhzpshhhpzzn
锼	phhhzpshzhhszn
锾	phhhzpnnphhpzn
锿	phhhznhszhpzpn
镀	phhhznhphsshzn
镁	phhhznphhshhpn
镆	phhhzhssszhhhpn
镇	phhhzhsszhhhhpn
镊	phhhzhsshhhznzn
镋	phhhzsnpnzszhpz
镍	phhhzpszhhhhspn
镏	phhhzpznzpszhsh
镐	phhhznhszhszszh
镕	phhhznnzpnpnszh
镖	phhhzhszsshhhspn
镗	phhhzsnpnzszhhsh
镙	phhhzszhshzznspn
镚	phhhzszspzhhpzhh
镛	phhhznhpzhhszhhs
镜	phhhznhnphszhhpz
镞	phhhznhzpphphhpn
镟	phhhznhzpphzshpn
镠	phhhzznhznhpnppp
镢	phhhzhpnphzsppzpn
镣	phhhzhpnnpszhhspn
镤	phhhzssnphnphhhpn
镧	phhhznszhszpnhspn
镪	phhhzzhzszhszhshn
镫	phhhzznppnhszhnph
镭	phhhzhnzsnnnnszhsh
镯	phhhzszsshpzszhshn
镰	phhhznhpnphzhhsspn
镲	phhhznnzpznnznhhspn
镳	phhhznhpzsshhzpznnnn
镶	phhhznhszhszhhhsshpzpn
长	phzn
门	nsz
闪	nszpn
闭	nszhsp
问	nszszh
闯	nszzzh
闰	nszhhsh
闱	nszhhzs
闲	nszhspn
间	nszszhh
闵	nsznhpn
闷	nsznznn
闸	nszszhhs
闹	nsznhszs
闺	nszhshhsh
闻	nszhsshhh
闽	nszszhshn
阀	nszpshzpn
阁	nszpznszh
阂	nsznhzppn
阄	nszpzszhhz
阅	nsznpszhpz
阉	nszhpnszhhz
阎	nszpzpshzhh
阐	nsznpszhhhs
阑	nszhsznphspn
阔	nsznnhphsszh
阕	nszznppnhhpn
阖	nszhshznszssh
阙	nsznphzsppzpn
阛	nszszsshhszhpzpn
阜	pszhzhhs
队	zspn
阨	zshpzz
阪	zsppzn
阬	zsnhpz
阮	zshhpz
阱	zshhps
防	zsnhzp
阳	zsszhh
阴	zspzhh
阵	zshzhs
阶	zspnps
阻	zsszhhh
阿	zshszhs
陀	zsnnzpz
陂	zszpszn
附	zspshsn
际	zshhspn
陆	zshhszs
陇	zshpzpn
陈	zshzspn
陉	zsznhsh
陋	zshszpnz
陌	zshpszhh
限	zszhhzpn
陒	zspzhpzz
陖	zsznpnpzn
陗	zssnpszhh
陛	zshzpzhsh
陡	zshshshpn
陨	zsszhszpn
险	zspnhnnph
陪	zsnhnphszh
陭	zshpnhszhs
陮	zspsnhhhsh
陱	zspznphspn
陲	zsphshsshh
陴	zspszhhphs
陵	zshshpnpzn
陶	zspzphhszs
陷	zspzpshzhh
隂	zspnhshhhzn
隅	zsszhhszshn
隆	zspznhphhsh
隋	zshphshszhh
階	zshzpzpszhh
随	zshpszhhnzn
隐	zspzzhhnznn
隔	zshszhsznphs
隘	zsnphpnszssh
隙	zsspnszhhspn
障	zsnhnphszhhhs
隧	zsnphpzpppnnzn
隶	zhhsnhpn
隻	psnhhhshzn
隼	psnhhhshhs
隽	psnhhhshzp
难	znpsnhhhsh
雀	spnpsnhhhsh
雁	hppspsnhhhsh
雃	hhpspsnhhhsh
雄	hpznpsnhhhsh
雅	hzsppsnhhhsh
集	psnhhhshhspn
雇	nzhppsnhhhsh
雉	phhpnpsnhhhsh
雊	pzszhpsnhhhsh
雌	shshpzpsnhhhsh
雍	nhzzppsnhhhsh
雏	pzzhhpsnhhhsh
雐	shzphzpsnhhhsh
雕	pzhshszhpsnhhhsh
雡	znhznhpnppppsnhhhsh
雨	hszsnnnn
雪	hnzsnnnnzhh
雬	hnzsnnnnhspn
雯	hnzsnnnnnhpn
零	hnzsnnnnpnnzn
雷	hnzsnnnnszhsh
雸	hnzsnnnnhsshh
雹	hnzsnnnnpzzhz
雾	hnzsnnnnpznzp
需	hnzsnnnnhpszss
霁	hnzsnnnnnhpnps
霂	hnzsnnnnnnhhspn
霄	hnzsnnnnsnpszhh
霆	hnzsnnnnphshzn
震	hnzsnnnnhphhzpn
霈	hnzsnnnnnnhhszh
霉	hnzsnnnnphzznhn
霍	hnzsnnnnpsnhhhsh
霏	hnzsnnnnshhhshhh
霑	hnzsnnnnnnhshszh
霓	hnzsnnnnpshzhhpz
霪	hnzsnnnnnnhpnnpphsh
青	hhshszhh
靓	hhshszhhszpz
靖	nhnphhhshszhh
静	hhshszhhpzzhhs
靛	hhshszhhnnzhshpn
非	shhhshhh
靠	phshszhshhhshhh
靡	nhphspnhspnshhhshhh
面	hpszsshhh
靥	hphpnnhpszsshhh
革	hsshszhhs
鞋	hsshszhhshshhsh
鞑	hsshszhhshpnnzn
鞕	hsshszhhshszhhpn
鞘	hsshszhhssnpszhh
鞠	hsshszhhspznphspn
鞦	hsshszhhsphspnnppn
鞭	hsshszhhspshszhhpn
鞺	hsshszhhssnpnzszhhsh
韦	hhzs
韧	hhzszpn
韨	hhzshpznn
韩	hsszhhhshhzs
韪	szhhhshpnhhzs
韫	hhzsszhhszssh
韬	hhzspnnppshzhh
韭	shhhshhhh
韮	hssshhhshhhh
韯	hshshhhshhhhzpn
韰	shpznznshhhshhhh
韱	pnpnhshhhshhhhzpn
音	nhnphszhh
韴	nhnphszhhhszs
韵	nhnphszhhpznh
韶	nhnphszhhzpszh
韻	nhnphszhhszhszhhhpn
页	hpszpn
顶	hshpszpn
顷	hzhpszpn
项	hshhpszpn
顺	psshpszpn
须	ppphpszpn
顽	hhpzhpszpn
顾	hpzzhpszpn
顿	hzszhpszpn
颁	pnzphpszpn
颂	pnznhpszpn
预	znzshpszpn
颅	shzhphpszpn
领	pnnznhpszpn
颇	zpsznhpszpn
颈	znhshhpszpn
颉	hshszhhpszpn
颊	hnphpnhpszpn
颌	pnhszhhpszpn
颍	pzszpnhpszpn
颏	nhzppnhpszpn
颐	hsszhszhpszpn
频	shshspphpszpn
颓	phspnpzhpszpn
颔	pnnzszhhpszpn
颖	pzphspnhpszpn
颗	szhhhspnhpszpn
题	szhhhshpnhpszpn
颚	szhszhhhzhpszpn
颛	szshpszsshpszpn
颜	nhnphpppphpszpn
额	nnzpznszhhpszpn
颠	hsszhhhhpnhpszpn
颢	szhhnhszhspnhpszpn
颤	nhszszhhszhhhhpszpn
颦	shshspphpszpnpszhhphs
颧	hssszhszhpsnhhhshhpszpn
风	pzpn
飒	nhnphpzpn
飓	pzpnszhhhhpn
飕	pzpnpshzhhszn
飘	hszsshhhspnpzpn
飙	hpnnhpnnhpnnpzpn
飚	pzpnnppnnppnnppn
飞	zpn
食	pnnzhhzpn
饤	pzzhs
饥	pzzpz
饧	pzzzpp
饨	pzzhzsz
饩	pzzphhz
饪	pzzphsh
饬	pzzphzp
饭	pzzppzn
饮	pzzpzpn
饯	pzzhhzpn
饰	pzzphszs
饱	pzzpzzhz
饲	pzzzhszh
饴	pzzznszh
饵	pzzhsshhh
饷	pzzpszszh
饸	pzzpnhszh
饹	pzzpznszh
饺	pzznhpnpn
饼	pzznphhps
饽	pzzhsnzzsh
饿	pzzphshzpn
馀	pzzpnhhspn
馁	pzzpnnpzph
馃	pzzszhhhspn
馄	pzzszhhhzpz
馅	pzzpzpshzhh
馆	pzznnzszhzh
馈	pzzszhshszpn
馉	pzzszznzszhh
馊	pzzpshzhhszn
馋	pzzpzszhpznn
馌	pzzhshznszssh
馍	pzzhssszhhhpn
馏	pzzpznzpszhsh
馐	pzznphhhpzshh
馑	pzzhsshszhhhsh
馒	pzzszhhszsshzn
馓	pzzhsshszhhphpn
馔	pzzzhzzhzhsshpn
馕	pzzhszhsnzszhszhhhsshpzpn
首	nphpszhhh
馗	pznphpszhhh
香	phspnszhh
馥	phspnszhhphszhhpzn
馨	hshzshppzznphspnszhh
马	zzh
驭	zzhzn
驮	zzhhpn
驯	zzhpss
驰	zzhzsz
驱	zzhhpnz
驳	zzhpnpn
驴	zzhnzhp
驶	zzhszhpn
驷	zzhszpzh
驸	zzhpshsn
驹	zzhpzszh
驻	zzhnhhsh
驼	zzhnnzpz
驽	zphznzzh
驾	zpszhzzh
驿	zzhznhhs
骀	zzhznszh
骁	zzhhzphpz
骂	szhszhzzh
骈	zzhnphhps
骊	zzhhsznszn
骋	zzhszhshhz
验	zzhpnhnnph
骍	zzhnhnphhs
骏	zzhznpnpzn
骐	zzhhsshhhpn
骑	zzhhpnhszhs
骒	zzhszhhhspn
骓	zzhpsnhhhsh
骗	zzhnzhpszhss
骚	zzhznnszhshn
骛	znzspphpnzzh
骜	hhshzpphpnzzh
骝	zzhpznzpszhsh
骞	nnzhhsshpnzzh
骟	zzhnzhpznhznh
骠	zzhhszsshhhspn
骡	zzhszhshzznspn
骢	zzhpszpznhnznn
骤	zzhhsshhhznpspppn
骥	zzhshhpzszhshhsshpn
骧	zzhnhszhszhhhsshpzpn
骨	szznzszhh
骰	szznzszhhpzzn
骶	szznzszhhpzhzn
骷	szznzszhhhsszh
骸	szznzszhhnhzppn
骻	szznzszhhhpnhhz
骼	szznzszhhpznszh
髋	szznzszhhnnzhssszpz
髌	szznzszhhnnzpshshpn
高	nhszhszszh
髟	hshhhznppp
鬓	hshhhznpppnnzpshshpn
髤	hshhhznppphspn
髦	hshhhznpppphhz
髪	hshhhznppphpzn
髭	hshhhznpppshshpz
髯	hshhhznpppszshh
髻	hshhhznppphshszh
鬃	hshhhznpppnnzhhspn
鬲	hszhsznphs
鬻	zhznphspnzhzhszhsznphs
鬼	pszhhpzzn
魁	pszhhpzznnnhs
魂	hhznpszhhpzzn
魄	pszhhpszhhpzzn
魅	pszhhpzznhhspn
魏	phspnzphpszhhpzzn
魔	nhphspnhspnpszhhpzzn
鱼	pzszhshh
鱿	pzszhshhhpzn
鲁	pzszhshhszhh
鲇	pzszhshhshszh
鲈	pzszhshhshzhp
鲍	pzszhshhpzzhz
鲎	nnpnzpzszhshh
鲛	pzszhshhnhpnpn
鲜	pzszhshhnphhhs
鲞	nphhpnpzszhshh
鲟	pzszhshhzhhhsn
鲠	pzszhshhhszhhpn
鲤	pzszhshhszhhshh
鲥	pzszhshhszhhhsn
鲨	nnhspnppzszhshh
鲱	pzszhshhshhhshhh
鲲	pzszhshhszhhhzpz
鳃	pzszhshhszhshnznn
鳄	pzszhshhszhszhhhz
鳅	pzszhshhphspnnppn
鳌	hhshzpphpnpzszhshh
鳏	pzszhshhszsshsppnn
鳔	pzszhshhhszsshhhspn
鳕	pzszhshhhnzsnnnnzhh
鳖	npszspnphpnpzszhshh
鳗	pzszhshhszhhszsshzn
鳘	phzznhnphpnpzszhshh
鳛	pzszhshhznhznhpszhh
鳜	pzszhshhhpnphzsppzpn
鳝	pzszhshhnphhhsnphszh
鳞	pzszhshhnphspnpznhzs
鳟	pzszhshhnphszpzhhhsn
鸟	pznzh
鸠	pzpznzh
鸡	znpznzh
鸢	hznpznzh
鸣	szhpznzh
鸥	hpnzpznzh
鸦	hzsppznzh
鸨	pzhspznzh
鸩	nzpzpznzh
鸪	hsszhpznzh
鸬	shzhppznzh
鸭	szhhspznzh
鸯	szhpnpznzh
鸱	pzhznpznzh
鸳	pznzzpznzh
鸵	pznzhnnzpz
鸷	hshpznpznzh
鸽	pnhszhpznzh
鸾	nhsspnpznzh
鸿	nnhhshpznzh
鹂	hsznsznpznzh
鹃	szhszhhpznzh
鹄	phshszhpznzh
鹅	phshzpnpznzh
鹉	hhshshznpznzh
鹊	hsshszhhpznzh
鹌	hpnszhhzpznzh
鹏	pzhhpzhhpznzh
鹑	nhszhzshpznzh
鹕	hsszhpzhhpznzh
鹜	znzspphpnpznzh
鹤	nzpsnhhhshpznzh
鹦	szpnszpnzphpznzh
鹧	nhphsshnnnnpznzh
鹫	nhszhspnhpznpznzh
鹭	szhshshpznszhpznzh
鹰	nhppspsnhhhshpznzh
鹿	nhpzsshhzpz
麒	nhpzsshhzpzhsshhhpn
麓	hspnhspnnhpzsshhzpz
麗	hsznhsznnhpzsshhzpz
麛	nhpzsshhzpzzhzhsshhh
麝	nhpzsshhzpzpszhhhphsn
麦	hhshpzn
麸	hhshpznhhpn
麹	hhshpznpznphspn
麺	hhshpznhpszsshhh
麻	nhphspnhspn
麾	nhphspnhspnphhz
黄	hsshszhshpn
黍	phspnpnsnhpn
黎	phspnpzppnsnhpn
黏	phspnpnsnhpnshszh
黑	sznphshhnnnn
黔	sznphshhnnnnpnnz
默	sznphshhnnnnhpnn
黛	pshznsznphshhnnnn
黥	sznphshhnnnnnhszhspn
黯	sznphshhnnnnnhnphszhh
黾	szhszhhz
鼋	hhpzszhszhhz
鼎	szhhhzhpshsz
鼓	hshszhnphhszn
鼠	pshzhhznnznnz
鼦	pshzhhznnznnzzpszh
鼹	pshzhhznnznnzszhhnnzzph
鼻	pszhhhszhshhps
鼾	pszhhhszhshhpshhs
齐	nhpnps
齑	nhpnshhhshhhhps
齿	shshpnzs
龀	shshpnzspz
龁	shshpnzsphz
龂	shshpnzspphs
龃	shshpnzsszhhh
龄	shshpnzspnnzn
龅	shshpnzspzzhz
龆	shshpnzszpszh
龇	shshpnzsshshpz
龈	shshpnzszhhzpn
龉	shshpnzshszhszh
龊	shshpnzsszhshpn
龋	shshpnzspszhszshn
龌	shshpnzszhphznhsh
龍	nhnphszhhhzhzhhh
龙	hpzpn
龚	hpzpnhsshpn
龛	pnhszhhpzpn
龟	pzhzhhz